"","Key","Anno","Mese","P1","P2","Total"
"1","Zona_1-Area_1-Sottoarea_5",2014,1,224,76,300
"2","Zona_1-Area_1-Sottoarea_5",2014,2,220,98,318
"3","Zona_1-Area_1-Sottoarea_5",2014,3,162,99,261
"4","Zona_1-Area_1-Sottoarea_5",2014,4,184,119,303
"5","Zona_1-Area_1-Sottoarea_5",2014,5,192,98,290
"6","Zona_1-Area_1-Sottoarea_5",2014,6,176,77,253
"7","Zona_1-Area_1-Sottoarea_5",2014,7,203,84,287
"8","Zona_1-Area_1-Sottoarea_5",2014,8,152,73,225
"9","Zona_1-Area_1-Sottoarea_5",2014,9,190,92,282
"10","Zona_1-Area_1-Sottoarea_5",2014,10,252,117,369
"11","Zona_1-Area_1-Sottoarea_5",2014,11,235,118,353
"12","Zona_1-Area_1-Sottoarea_5",2014,12,195,102,297
"13","Zona_1-Area_1-Sottoarea_5",2015,1,199,88,287
"14","Zona_1-Area_1-Sottoarea_5",2015,2,195,118,313
"15","Zona_1-Area_1-Sottoarea_5",2015,3,219,101,320
"16","Zona_1-Area_1-Sottoarea_5",2015,4,196,108,304
"17","Zona_1-Area_1-Sottoarea_5",2015,5,175,100,275
"18","Zona_1-Area_1-Sottoarea_5",2015,6,185,82,267
"19","Zona_1-Area_1-Sottoarea_5",2015,7,210,91,301
"20","Zona_1-Area_1-Sottoarea_5",2015,8,165,71,236
"21","Zona_1-Area_1-Sottoarea_5",2015,9,235,84,319
"22","Zona_1-Area_1-Sottoarea_5",2015,10,227,90,317
"23","Zona_1-Area_1-Sottoarea_5",2015,11,214,92,306
"24","Zona_1-Area_1-Sottoarea_5",2015,12,206,81,287
"25","Zona_1-Area_1-Sottoarea_5",2016,1,212,72,284
"26","Zona_1-Area_1-Sottoarea_5",2016,2,228,105,333
"27","Zona_1-Area_1-Sottoarea_5",2016,3,240,104,344
"28","Zona_1-Area_1-Sottoarea_5",2016,4,215,99,314
"29","Zona_1-Area_1-Sottoarea_5",2016,5,120,59,179
"30","Zona_1-Area_1-Sottoarea_5",2016,6,0,0,0
"31","Zona_1-Area_1-Sottoarea_5",2016,7,0,0,0
"32","Zona_1-Area_1-Sottoarea_5",2016,8,0,0,0
"33","Zona_1-Area_1-Sottoarea_5",2016,9,0,0,0
"34","Zona_1-Area_1-Sottoarea_5",2016,10,0,0,0
"35","Zona_1-Area_1-Sottoarea_5",2016,11,0,0,0
"36","Zona_1-Area_1-Sottoarea_5",2016,12,0,0,0
"37","Zona_1-Area_1-Sottoarea_6",2014,1,27,9,36
"38","Zona_1-Area_1-Sottoarea_6",2014,2,32,13,45
"39","Zona_1-Area_1-Sottoarea_6",2014,3,23,8,31
"40","Zona_1-Area_1-Sottoarea_6",2014,4,29,14,43
"41","Zona_1-Area_1-Sottoarea_6",2014,5,24,4,28
"42","Zona_1-Area_1-Sottoarea_6",2014,6,27,9,36
"43","Zona_1-Area_1-Sottoarea_6",2014,7,35,7,42
"44","Zona_1-Area_1-Sottoarea_6",2014,8,21,5,26
"45","Zona_1-Area_1-Sottoarea_6",2014,9,24,8,32
"46","Zona_1-Area_1-Sottoarea_6",2014,10,34,12,46
"47","Zona_1-Area_1-Sottoarea_6",2014,11,28,17,45
"48","Zona_1-Area_1-Sottoarea_6",2014,12,26,11,37
"49","Zona_1-Area_1-Sottoarea_6",2015,1,30,2,32
"50","Zona_1-Area_1-Sottoarea_6",2015,2,26,9,35
"51","Zona_1-Area_1-Sottoarea_6",2015,3,30,12,42
"52","Zona_1-Area_1-Sottoarea_6",2015,4,24,10,34
"53","Zona_1-Area_1-Sottoarea_6",2015,5,22,19,41
"54","Zona_1-Area_1-Sottoarea_6",2015,6,24,8,32
"55","Zona_1-Area_1-Sottoarea_6",2015,7,22,6,28
"56","Zona_1-Area_1-Sottoarea_6",2015,8,21,5,26
"57","Zona_1-Area_1-Sottoarea_6",2015,9,25,13,38
"58","Zona_1-Area_1-Sottoarea_6",2015,10,20,12,32
"59","Zona_1-Area_1-Sottoarea_6",2015,11,19,7,26
"60","Zona_1-Area_1-Sottoarea_6",2015,12,24,13,37
"61","Zona_1-Area_1-Sottoarea_6",2016,1,22,7,29
"62","Zona_1-Area_1-Sottoarea_6",2016,2,27,16,43
"63","Zona_1-Area_1-Sottoarea_6",2016,3,24,14,38
"64","Zona_1-Area_1-Sottoarea_6",2016,4,29,11,40
"65","Zona_1-Area_1-Sottoarea_6",2016,5,14,3,17
"66","Zona_1-Area_1-Sottoarea_6",2016,6,0,0,0
"67","Zona_1-Area_1-Sottoarea_6",2016,7,0,0,0
"68","Zona_1-Area_1-Sottoarea_6",2016,8,0,0,0
"69","Zona_1-Area_1-Sottoarea_6",2016,9,0,0,0
"70","Zona_1-Area_1-Sottoarea_6",2016,10,0,0,0
"71","Zona_1-Area_1-Sottoarea_6",2016,11,0,0,0
"72","Zona_1-Area_1-Sottoarea_6",2016,12,0,0,0
"73","Zona_1-Area_2-Sottoarea_7",2014,1,80,29,109
"74","Zona_1-Area_2-Sottoarea_7",2014,2,73,30,103
"75","Zona_1-Area_2-Sottoarea_7",2014,3,52,25,77
"76","Zona_1-Area_2-Sottoarea_7",2014,4,58,26,84
"77","Zona_1-Area_2-Sottoarea_7",2014,5,63,34,97
"78","Zona_1-Area_2-Sottoarea_7",2014,6,58,31,89
"79","Zona_1-Area_2-Sottoarea_7",2014,7,64,30,94
"80","Zona_1-Area_2-Sottoarea_7",2014,8,45,28,73
"81","Zona_1-Area_2-Sottoarea_7",2014,9,67,33,100
"82","Zona_1-Area_2-Sottoarea_7",2014,10,95,44,139
"83","Zona_1-Area_2-Sottoarea_7",2014,11,77,36,113
"84","Zona_1-Area_2-Sottoarea_7",2014,12,68,34,102
"85","Zona_1-Area_2-Sottoarea_7",2015,1,65,35,100
"86","Zona_1-Area_2-Sottoarea_7",2015,2,65,40,105
"87","Zona_1-Area_2-Sottoarea_7",2015,3,74,31,105
"88","Zona_1-Area_2-Sottoarea_7",2015,4,72,34,106
"89","Zona_1-Area_2-Sottoarea_7",2015,5,61,42,103
"90","Zona_1-Area_2-Sottoarea_7",2015,6,62,37,99
"91","Zona_1-Area_2-Sottoarea_7",2015,7,67,34,101
"92","Zona_1-Area_2-Sottoarea_7",2015,8,59,30,89
"93","Zona_1-Area_2-Sottoarea_7",2015,9,87,28,115
"94","Zona_1-Area_2-Sottoarea_7",2015,10,99,35,134
"95","Zona_1-Area_2-Sottoarea_7",2015,11,84,28,112
"96","Zona_1-Area_2-Sottoarea_7",2015,12,77,24,101
"97","Zona_1-Area_2-Sottoarea_7",2016,1,76,24,100
"98","Zona_1-Area_2-Sottoarea_7",2016,2,70,34,104
"99","Zona_1-Area_2-Sottoarea_7",2016,3,68,35,103
"100","Zona_1-Area_2-Sottoarea_7",2016,4,72,98,170
"101","Zona_1-Area_2-Sottoarea_7",2016,5,42,35,77
"102","Zona_1-Area_2-Sottoarea_7",2016,6,0,0,0
"103","Zona_1-Area_2-Sottoarea_7",2016,7,0,0,0
"104","Zona_1-Area_2-Sottoarea_7",2016,8,0,0,0
"105","Zona_1-Area_2-Sottoarea_7",2016,9,0,0,0
"106","Zona_1-Area_2-Sottoarea_7",2016,10,0,0,0
"107","Zona_1-Area_2-Sottoarea_7",2016,11,0,0,0
"108","Zona_1-Area_2-Sottoarea_7",2016,12,0,0,0
"109","Zona_1-Area_2-Sottoarea_8",2014,1,149,55,204
"110","Zona_1-Area_2-Sottoarea_8",2014,2,149,65,214
"111","Zona_1-Area_2-Sottoarea_8",2014,3,103,53,156
"112","Zona_1-Area_2-Sottoarea_8",2014,4,128,59,187
"113","Zona_1-Area_2-Sottoarea_8",2014,5,115,51,166
"114","Zona_1-Area_2-Sottoarea_8",2014,6,115,54,169
"115","Zona_1-Area_2-Sottoarea_8",2014,7,127,59,186
"116","Zona_1-Area_2-Sottoarea_8",2014,8,100,45,145
"117","Zona_1-Area_2-Sottoarea_8",2014,9,111,49,160
"118","Zona_1-Area_2-Sottoarea_8",2014,10,148,76,224
"119","Zona_1-Area_2-Sottoarea_8",2014,11,139,70,209
"120","Zona_1-Area_2-Sottoarea_8",2014,12,115,58,173
"121","Zona_1-Area_2-Sottoarea_8",2015,1,128,62,190
"122","Zona_1-Area_2-Sottoarea_8",2015,2,135,80,215
"123","Zona_1-Area_2-Sottoarea_8",2015,3,142,87,229
"124","Zona_1-Area_2-Sottoarea_8",2015,4,120,84,204
"125","Zona_1-Area_2-Sottoarea_8",2015,5,123,104,227
"126","Zona_1-Area_2-Sottoarea_8",2015,6,136,63,199
"127","Zona_1-Area_2-Sottoarea_8",2015,7,141,61,202
"128","Zona_1-Area_2-Sottoarea_8",2015,8,110,58,168
"129","Zona_1-Area_2-Sottoarea_8",2015,9,145,68,213
"130","Zona_1-Area_2-Sottoarea_8",2015,10,168,74,242
"131","Zona_1-Area_2-Sottoarea_8",2015,11,170,70,240
"132","Zona_1-Area_2-Sottoarea_8",2015,12,161,59,220
"133","Zona_1-Area_2-Sottoarea_8",2016,1,160,57,217
"134","Zona_1-Area_2-Sottoarea_8",2016,2,158,72,230
"135","Zona_1-Area_2-Sottoarea_8",2016,3,163,90,253
"136","Zona_1-Area_2-Sottoarea_8",2016,4,148,72,220
"137","Zona_1-Area_2-Sottoarea_8",2016,5,84,35,119
"138","Zona_1-Area_2-Sottoarea_8",2016,6,0,0,0
"139","Zona_1-Area_2-Sottoarea_8",2016,7,0,0,0
"140","Zona_1-Area_2-Sottoarea_8",2016,8,0,0,0
"141","Zona_1-Area_2-Sottoarea_8",2016,9,0,0,0
"142","Zona_1-Area_2-Sottoarea_8",2016,10,0,0,0
"143","Zona_1-Area_2-Sottoarea_8",2016,11,0,0,0
"144","Zona_1-Area_2-Sottoarea_8",2016,12,0,0,0
"145","Zona_2-Area_3-Sottoarea_15",2014,1,33,19,52
"146","Zona_2-Area_3-Sottoarea_15",2014,2,32,27,59
"147","Zona_2-Area_3-Sottoarea_15",2014,3,33,19,52
"148","Zona_2-Area_3-Sottoarea_15",2014,4,35,20,55
"149","Zona_2-Area_3-Sottoarea_15",2014,5,35,21,56
"150","Zona_2-Area_3-Sottoarea_15",2014,6,33,17,50
"151","Zona_2-Area_3-Sottoarea_15",2014,7,32,21,53
"152","Zona_2-Area_3-Sottoarea_15",2014,8,21,16,37
"153","Zona_2-Area_3-Sottoarea_15",2014,9,34,14,48
"154","Zona_2-Area_3-Sottoarea_15",2014,10,45,26,71
"155","Zona_2-Area_3-Sottoarea_15",2014,11,35,27,62
"156","Zona_2-Area_3-Sottoarea_15",2014,12,34,28,62
"157","Zona_2-Area_3-Sottoarea_15",2015,1,31,18,49
"158","Zona_2-Area_3-Sottoarea_15",2015,2,38,27,65
"159","Zona_2-Area_3-Sottoarea_15",2015,3,38,28,66
"160","Zona_2-Area_3-Sottoarea_15",2015,4,61,34,95
"161","Zona_2-Area_3-Sottoarea_15",2015,5,57,40,97
"162","Zona_2-Area_3-Sottoarea_15",2015,6,54,20,74
"163","Zona_2-Area_3-Sottoarea_15",2015,7,49,23,72
"164","Zona_2-Area_3-Sottoarea_15",2015,8,34,20,54
"165","Zona_2-Area_3-Sottoarea_15",2015,9,52,20,72
"166","Zona_2-Area_3-Sottoarea_15",2015,10,50,31,81
"167","Zona_2-Area_3-Sottoarea_15",2015,11,42,22,64
"168","Zona_2-Area_3-Sottoarea_15",2015,12,36,25,61
"169","Zona_2-Area_3-Sottoarea_15",2016,1,42,47,89
"170","Zona_2-Area_3-Sottoarea_15",2016,2,60,40,100
"171","Zona_2-Area_3-Sottoarea_15",2016,3,61,33,94
"172","Zona_2-Area_3-Sottoarea_15",2016,4,60,30,90
"173","Zona_2-Area_3-Sottoarea_15",2016,5,35,20,55
"174","Zona_2-Area_3-Sottoarea_15",2016,6,0,0,0
"175","Zona_2-Area_3-Sottoarea_15",2016,7,0,0,0
"176","Zona_2-Area_3-Sottoarea_15",2016,8,0,0,0
"177","Zona_2-Area_3-Sottoarea_15",2016,9,0,0,0
"178","Zona_2-Area_3-Sottoarea_15",2016,10,0,0,0
"179","Zona_2-Area_3-Sottoarea_15",2016,11,0,0,0
"180","Zona_2-Area_3-Sottoarea_15",2016,12,0,0,0
"181","Zona_2-Area_3-Sottoarea_16",2014,1,126,82,208
"182","Zona_2-Area_3-Sottoarea_16",2014,2,137,89,226
"183","Zona_2-Area_3-Sottoarea_16",2014,3,103,77,180
"184","Zona_2-Area_3-Sottoarea_16",2014,4,108,64,172
"185","Zona_2-Area_3-Sottoarea_16",2014,5,99,69,168
"186","Zona_2-Area_3-Sottoarea_16",2014,6,144,100,244
"187","Zona_2-Area_3-Sottoarea_16",2014,7,132,83,215
"188","Zona_2-Area_3-Sottoarea_16",2014,8,102,68,170
"189","Zona_2-Area_3-Sottoarea_16",2014,9,124,60,184
"190","Zona_2-Area_3-Sottoarea_16",2014,10,136,93,229
"191","Zona_2-Area_3-Sottoarea_16",2014,11,132,91,223
"192","Zona_2-Area_3-Sottoarea_16",2014,12,135,72,207
"193","Zona_2-Area_3-Sottoarea_16",2015,1,124,71,195
"194","Zona_2-Area_3-Sottoarea_16",2015,2,139,96,235
"195","Zona_2-Area_3-Sottoarea_16",2015,3,153,133,286
"196","Zona_2-Area_3-Sottoarea_16",2015,4,136,93,229
"197","Zona_2-Area_3-Sottoarea_16",2015,5,119,95,214
"198","Zona_2-Area_3-Sottoarea_16",2015,6,143,73,216
"199","Zona_2-Area_3-Sottoarea_16",2015,7,148,83,231
"200","Zona_2-Area_3-Sottoarea_16",2015,8,103,60,163
"201","Zona_2-Area_3-Sottoarea_16",2015,9,160,67,227
"202","Zona_2-Area_3-Sottoarea_16",2015,10,167,93,260
"203","Zona_2-Area_3-Sottoarea_16",2015,11,154,84,238
"204","Zona_2-Area_3-Sottoarea_16",2015,12,148,79,227
"205","Zona_2-Area_3-Sottoarea_16",2016,1,148,72,220
"206","Zona_2-Area_3-Sottoarea_16",2016,2,165,91,256
"207","Zona_2-Area_3-Sottoarea_16",2016,3,156,109,265
"208","Zona_2-Area_3-Sottoarea_16",2016,4,176,88,264
"209","Zona_2-Area_3-Sottoarea_16",2016,5,96,66,162
"210","Zona_2-Area_3-Sottoarea_16",2016,6,0,0,0
"211","Zona_2-Area_3-Sottoarea_16",2016,7,0,0,0
"212","Zona_2-Area_3-Sottoarea_16",2016,8,0,0,0
"213","Zona_2-Area_3-Sottoarea_16",2016,9,0,0,0
"214","Zona_2-Area_3-Sottoarea_16",2016,10,0,0,0
"215","Zona_2-Area_3-Sottoarea_16",2016,11,0,0,0
"216","Zona_2-Area_3-Sottoarea_16",2016,12,0,0,0
"217","Zona_2-Area_4-Sottoarea_17",2014,1,16,2,18
"218","Zona_2-Area_4-Sottoarea_17",2014,2,23,9,32
"219","Zona_2-Area_4-Sottoarea_17",2014,3,19,10,29
"220","Zona_2-Area_4-Sottoarea_17",2014,4,15,4,19
"221","Zona_2-Area_4-Sottoarea_17",2014,5,16,4,20
"222","Zona_2-Area_4-Sottoarea_17",2014,6,25,5,30
"223","Zona_2-Area_4-Sottoarea_17",2014,7,16,7,23
"224","Zona_2-Area_4-Sottoarea_17",2014,8,14,6,20
"225","Zona_2-Area_4-Sottoarea_17",2014,9,20,10,30
"226","Zona_2-Area_4-Sottoarea_17",2014,10,20,6,26
"227","Zona_2-Area_4-Sottoarea_17",2014,11,21,9,30
"228","Zona_2-Area_4-Sottoarea_17",2014,12,26,13,39
"229","Zona_2-Area_4-Sottoarea_17",2015,1,20,6,26
"230","Zona_2-Area_4-Sottoarea_17",2015,2,22,13,35
"231","Zona_2-Area_4-Sottoarea_17",2015,3,23,22,45
"232","Zona_2-Area_4-Sottoarea_17",2015,4,22,12,34
"233","Zona_2-Area_4-Sottoarea_17",2015,5,18,14,32
"234","Zona_2-Area_4-Sottoarea_17",2015,6,20,6,26
"235","Zona_2-Area_4-Sottoarea_17",2015,7,19,9,28
"236","Zona_2-Area_4-Sottoarea_17",2015,8,11,3,14
"237","Zona_2-Area_4-Sottoarea_17",2015,9,23,6,29
"238","Zona_2-Area_4-Sottoarea_17",2015,10,18,11,29
"239","Zona_2-Area_4-Sottoarea_17",2015,11,18,3,21
"240","Zona_2-Area_4-Sottoarea_17",2015,12,14,2,16
"241","Zona_2-Area_4-Sottoarea_17",2016,1,21,5,26
"242","Zona_2-Area_4-Sottoarea_17",2016,2,28,12,40
"243","Zona_2-Area_4-Sottoarea_17",2016,3,26,10,36
"244","Zona_2-Area_4-Sottoarea_17",2016,4,23,7,30
"245","Zona_2-Area_4-Sottoarea_17",2016,5,14,4,18
"246","Zona_2-Area_4-Sottoarea_17",2016,6,0,0,0
"247","Zona_2-Area_4-Sottoarea_17",2016,7,0,0,0
"248","Zona_2-Area_4-Sottoarea_17",2016,8,0,0,0
"249","Zona_2-Area_4-Sottoarea_17",2016,9,0,0,0
"250","Zona_2-Area_4-Sottoarea_17",2016,10,0,0,0
"251","Zona_2-Area_4-Sottoarea_17",2016,11,0,0,0
"252","Zona_2-Area_4-Sottoarea_17",2016,12,0,0,0
"253","Zona_2-Area_4-Sottoarea_18",2014,1,72,38,110
"254","Zona_2-Area_4-Sottoarea_18",2014,2,81,36,117
"255","Zona_2-Area_4-Sottoarea_18",2014,3,58,27,85
"256","Zona_2-Area_4-Sottoarea_18",2014,4,67,31,98
"257","Zona_2-Area_4-Sottoarea_18",2014,5,62,30,92
"258","Zona_2-Area_4-Sottoarea_18",2014,6,83,33,116
"259","Zona_2-Area_4-Sottoarea_18",2014,7,75,35,110
"260","Zona_2-Area_4-Sottoarea_18",2014,8,56,29,85
"261","Zona_2-Area_4-Sottoarea_18",2014,9,75,32,107
"262","Zona_2-Area_4-Sottoarea_18",2014,10,82,46,128
"263","Zona_2-Area_4-Sottoarea_18",2014,11,67,33,100
"264","Zona_2-Area_4-Sottoarea_18",2014,12,73,41,114
"265","Zona_2-Area_4-Sottoarea_18",2015,1,74,32,106
"266","Zona_2-Area_4-Sottoarea_18",2015,2,87,41,128
"267","Zona_2-Area_4-Sottoarea_18",2015,3,94,53,147
"268","Zona_2-Area_4-Sottoarea_18",2015,4,86,37,123
"269","Zona_2-Area_4-Sottoarea_18",2015,5,76,43,119
"270","Zona_2-Area_4-Sottoarea_18",2015,6,100,36,136
"271","Zona_2-Area_4-Sottoarea_18",2015,7,103,36,139
"272","Zona_2-Area_4-Sottoarea_18",2015,8,69,29,98
"273","Zona_2-Area_4-Sottoarea_18",2015,9,107,37,144
"274","Zona_2-Area_4-Sottoarea_18",2015,10,116,47,163
"275","Zona_2-Area_4-Sottoarea_18",2015,11,115,41,156
"276","Zona_2-Area_4-Sottoarea_18",2015,12,99,36,135
"277","Zona_2-Area_4-Sottoarea_18",2016,1,97,36,133
"278","Zona_2-Area_4-Sottoarea_18",2016,2,163,42,205
"279","Zona_2-Area_4-Sottoarea_18",2016,3,161,49,210
"280","Zona_2-Area_4-Sottoarea_18",2016,4,148,47,195
"281","Zona_2-Area_4-Sottoarea_18",2016,5,83,30,113
"282","Zona_2-Area_4-Sottoarea_18",2016,6,0,0,0
"283","Zona_2-Area_4-Sottoarea_18",2016,7,0,0,0
"284","Zona_2-Area_4-Sottoarea_18",2016,8,0,0,0
"285","Zona_2-Area_4-Sottoarea_18",2016,9,0,0,0
"286","Zona_2-Area_4-Sottoarea_18",2016,10,0,0,0
"287","Zona_2-Area_4-Sottoarea_18",2016,11,0,0,0
"288","Zona_2-Area_4-Sottoarea_18",2016,12,0,0,0
"289","Zona_2-Area_4-Sottoarea_19",2014,1,43,22,65
"290","Zona_2-Area_4-Sottoarea_19",2014,2,41,26,67
"291","Zona_2-Area_4-Sottoarea_19",2014,3,34,23,57
"292","Zona_2-Area_4-Sottoarea_19",2014,4,39,23,62
"293","Zona_2-Area_4-Sottoarea_19",2014,5,32,25,57
"294","Zona_2-Area_4-Sottoarea_19",2014,6,49,25,74
"295","Zona_2-Area_4-Sottoarea_19",2014,7,40,21,61
"296","Zona_2-Area_4-Sottoarea_19",2014,8,29,19,48
"297","Zona_2-Area_4-Sottoarea_19",2014,9,31,12,43
"298","Zona_2-Area_4-Sottoarea_19",2014,10,53,36,89
"299","Zona_2-Area_4-Sottoarea_19",2014,11,38,37,75
"300","Zona_2-Area_4-Sottoarea_19",2014,12,43,39,82
"301","Zona_2-Area_4-Sottoarea_19",2015,1,40,25,65
"302","Zona_2-Area_4-Sottoarea_19",2015,2,44,38,82
"303","Zona_2-Area_4-Sottoarea_19",2015,3,50,48,98
"304","Zona_2-Area_4-Sottoarea_19",2015,4,51,39,90
"305","Zona_2-Area_4-Sottoarea_19",2015,5,51,39,90
"306","Zona_2-Area_4-Sottoarea_19",2015,6,57,27,84
"307","Zona_2-Area_4-Sottoarea_19",2015,7,60,49,109
"308","Zona_2-Area_4-Sottoarea_19",2015,8,35,31,66
"309","Zona_2-Area_4-Sottoarea_19",2015,9,58,38,96
"310","Zona_2-Area_4-Sottoarea_19",2015,10,59,40,99
"311","Zona_2-Area_4-Sottoarea_19",2015,11,60,50,110
"312","Zona_2-Area_4-Sottoarea_19",2015,12,52,44,96
"313","Zona_2-Area_4-Sottoarea_19",2016,1,67,33,100
"314","Zona_2-Area_4-Sottoarea_19",2016,2,86,53,139
"315","Zona_2-Area_4-Sottoarea_19",2016,3,97,42,139
"316","Zona_2-Area_4-Sottoarea_19",2016,4,89,33,122
"317","Zona_2-Area_4-Sottoarea_19",2016,5,47,23,70
"318","Zona_2-Area_4-Sottoarea_19",2016,6,0,0,0
"319","Zona_2-Area_4-Sottoarea_19",2016,7,0,0,0
"320","Zona_2-Area_4-Sottoarea_19",2016,8,0,0,0
"321","Zona_2-Area_4-Sottoarea_19",2016,9,0,0,0
"322","Zona_2-Area_4-Sottoarea_19",2016,10,0,0,0
"323","Zona_2-Area_4-Sottoarea_19",2016,11,0,0,0
"324","Zona_2-Area_4-Sottoarea_19",2016,12,0,0,0
"325","Zona_2-Area_4-Sottoarea_20",2014,1,0,0,0
"326","Zona_2-Area_4-Sottoarea_20",2014,2,0,0,0
"327","Zona_2-Area_4-Sottoarea_20",2014,3,0,0,0
"328","Zona_2-Area_4-Sottoarea_20",2014,4,0,0,0
"329","Zona_2-Area_4-Sottoarea_20",2014,5,1,1,2
"330","Zona_2-Area_4-Sottoarea_20",2014,6,1,1,2
"331","Zona_2-Area_4-Sottoarea_20",2014,7,0,0,0
"332","Zona_2-Area_4-Sottoarea_20",2014,8,0,0,0
"333","Zona_2-Area_4-Sottoarea_20",2014,9,0,0,0
"334","Zona_2-Area_4-Sottoarea_20",2014,10,0,0,0
"335","Zona_2-Area_4-Sottoarea_20",2014,11,1,0,1
"336","Zona_2-Area_4-Sottoarea_20",2014,12,0,0,0
"337","Zona_2-Area_4-Sottoarea_20",2015,1,0,0,0
"338","Zona_2-Area_4-Sottoarea_20",2015,2,1,0,1
"339","Zona_2-Area_4-Sottoarea_20",2015,3,1,0,1
"340","Zona_2-Area_4-Sottoarea_20",2015,4,0,0,0
"341","Zona_2-Area_4-Sottoarea_20",2015,5,0,0,0
"342","Zona_2-Area_4-Sottoarea_20",2015,6,0,0,0
"343","Zona_2-Area_4-Sottoarea_20",2015,7,0,0,0
"344","Zona_2-Area_4-Sottoarea_20",2015,8,0,0,0
"345","Zona_2-Area_4-Sottoarea_20",2015,9,1,0,1
"346","Zona_2-Area_4-Sottoarea_20",2015,10,0,0,0
"347","Zona_2-Area_4-Sottoarea_20",2015,11,0,0,0
"348","Zona_2-Area_4-Sottoarea_20",2015,12,0,0,0
"349","Zona_2-Area_4-Sottoarea_20",2016,1,1,0,1
"350","Zona_2-Area_4-Sottoarea_20",2016,2,0,0,0
"351","Zona_2-Area_4-Sottoarea_20",2016,3,0,0,0
"352","Zona_2-Area_4-Sottoarea_20",2016,4,0,0,0
"353","Zona_2-Area_4-Sottoarea_20",2016,5,0,0,0
"354","Zona_2-Area_4-Sottoarea_20",2016,6,0,0,0
"355","Zona_2-Area_4-Sottoarea_20",2016,7,0,0,0
"356","Zona_2-Area_4-Sottoarea_20",2016,8,0,0,0
"357","Zona_2-Area_4-Sottoarea_20",2016,9,0,0,0
"358","Zona_2-Area_4-Sottoarea_20",2016,10,0,0,0
"359","Zona_2-Area_4-Sottoarea_20",2016,11,0,0,0
"360","Zona_2-Area_4-Sottoarea_20",2016,12,0,0,0
"361","Zona_3-Area_5-Sottoarea_30",2014,1,81,29,110
"362","Zona_3-Area_5-Sottoarea_30",2014,2,80,34,114
"363","Zona_3-Area_5-Sottoarea_30",2014,3,66,31,97
"364","Zona_3-Area_5-Sottoarea_30",2014,4,77,34,111
"365","Zona_3-Area_5-Sottoarea_30",2014,5,74,31,105
"366","Zona_3-Area_5-Sottoarea_30",2014,6,82,29,111
"367","Zona_3-Area_5-Sottoarea_30",2014,7,82,32,114
"368","Zona_3-Area_5-Sottoarea_30",2014,8,53,21,74
"369","Zona_3-Area_5-Sottoarea_30",2014,9,77,29,106
"370","Zona_3-Area_5-Sottoarea_30",2014,10,81,43,124
"371","Zona_3-Area_5-Sottoarea_30",2014,11,74,40,114
"372","Zona_3-Area_5-Sottoarea_30",2014,12,67,40,107
"373","Zona_3-Area_5-Sottoarea_30",2015,1,75,30,105
"374","Zona_3-Area_5-Sottoarea_30",2015,2,83,39,122
"375","Zona_3-Area_5-Sottoarea_30",2015,3,80,50,130
"376","Zona_3-Area_5-Sottoarea_30",2015,4,89,39,128
"377","Zona_3-Area_5-Sottoarea_30",2015,5,89,51,140
"378","Zona_3-Area_5-Sottoarea_30",2015,6,98,38,136
"379","Zona_3-Area_5-Sottoarea_30",2015,7,84,37,121
"380","Zona_3-Area_5-Sottoarea_30",2015,8,59,26,85
"381","Zona_3-Area_5-Sottoarea_30",2015,9,97,32,129
"382","Zona_3-Area_5-Sottoarea_30",2015,10,115,37,152
"383","Zona_3-Area_5-Sottoarea_30",2015,11,121,38,159
"384","Zona_3-Area_5-Sottoarea_30",2015,12,104,30,134
"385","Zona_3-Area_5-Sottoarea_30",2016,1,117,34,151
"386","Zona_3-Area_5-Sottoarea_30",2016,2,143,49,192
"387","Zona_3-Area_5-Sottoarea_30",2016,3,155,47,202
"388","Zona_3-Area_5-Sottoarea_30",2016,4,141,38,179
"389","Zona_3-Area_5-Sottoarea_30",2016,5,78,26,104
"390","Zona_3-Area_5-Sottoarea_30",2016,6,0,0,0
"391","Zona_3-Area_5-Sottoarea_30",2016,7,0,0,0
"392","Zona_3-Area_5-Sottoarea_30",2016,8,0,0,0
"393","Zona_3-Area_5-Sottoarea_30",2016,9,0,0,0
"394","Zona_3-Area_5-Sottoarea_30",2016,10,0,0,0
"395","Zona_3-Area_5-Sottoarea_30",2016,11,0,0,0
"396","Zona_3-Area_5-Sottoarea_30",2016,12,0,0,0
"397","Zona_3-Area_5-Sottoarea_31",2014,1,114,51,165
"398","Zona_3-Area_5-Sottoarea_31",2014,2,115,51,166
"399","Zona_3-Area_5-Sottoarea_31",2014,3,89,44,133
"400","Zona_3-Area_5-Sottoarea_31",2014,4,107,49,156
"401","Zona_3-Area_5-Sottoarea_31",2014,5,107,48,155
"402","Zona_3-Area_5-Sottoarea_31",2014,6,110,53,163
"403","Zona_3-Area_5-Sottoarea_31",2014,7,114,46,160
"404","Zona_3-Area_5-Sottoarea_31",2014,8,76,34,110
"405","Zona_3-Area_5-Sottoarea_31",2014,9,132,48,180
"406","Zona_3-Area_5-Sottoarea_31",2014,10,155,72,227
"407","Zona_3-Area_5-Sottoarea_31",2014,11,141,53,194
"408","Zona_3-Area_5-Sottoarea_31",2014,12,125,56,181
"409","Zona_3-Area_5-Sottoarea_31",2015,1,124,60,184
"410","Zona_3-Area_5-Sottoarea_31",2015,2,142,69,211
"411","Zona_3-Area_5-Sottoarea_31",2015,3,148,95,243
"412","Zona_3-Area_5-Sottoarea_31",2015,4,131,60,191
"413","Zona_3-Area_5-Sottoarea_31",2015,5,130,65,195
"414","Zona_3-Area_5-Sottoarea_31",2015,6,160,56,216
"415","Zona_3-Area_5-Sottoarea_31",2015,7,136,52,188
"416","Zona_3-Area_5-Sottoarea_31",2015,8,105,42,147
"417","Zona_3-Area_5-Sottoarea_31",2015,9,192,47,239
"418","Zona_3-Area_5-Sottoarea_31",2015,10,210,59,269
"419","Zona_3-Area_5-Sottoarea_31",2015,11,191,54,245
"420","Zona_3-Area_5-Sottoarea_31",2015,12,167,43,210
"421","Zona_3-Area_5-Sottoarea_31",2016,1,195,43,238
"422","Zona_3-Area_5-Sottoarea_31",2016,2,205,65,270
"423","Zona_3-Area_5-Sottoarea_31",2016,3,236,72,308
"424","Zona_3-Area_5-Sottoarea_31",2016,4,198,59,257
"425","Zona_3-Area_5-Sottoarea_31",2016,5,111,38,149
"426","Zona_3-Area_5-Sottoarea_31",2016,6,0,0,0
"427","Zona_3-Area_5-Sottoarea_31",2016,7,0,0,0
"428","Zona_3-Area_5-Sottoarea_31",2016,8,0,0,0
"429","Zona_3-Area_5-Sottoarea_31",2016,9,0,0,0
"430","Zona_3-Area_5-Sottoarea_31",2016,10,0,0,0
"431","Zona_3-Area_5-Sottoarea_31",2016,11,0,0,0
"432","Zona_3-Area_5-Sottoarea_31",2016,12,0,0,0
"433","Zona_3-Area_5-Sottoarea_32",2014,1,3,0,3
"434","Zona_3-Area_5-Sottoarea_32",2014,2,1,0,1
"435","Zona_3-Area_5-Sottoarea_32",2014,3,2,0,2
"436","Zona_3-Area_5-Sottoarea_32",2014,4,3,1,4
"437","Zona_3-Area_5-Sottoarea_32",2014,5,2,1,3
"438","Zona_3-Area_5-Sottoarea_32",2014,6,4,2,6
"439","Zona_3-Area_5-Sottoarea_32",2014,7,3,0,3
"440","Zona_3-Area_5-Sottoarea_32",2014,8,2,0,2
"441","Zona_3-Area_5-Sottoarea_32",2014,9,5,0,5
"442","Zona_3-Area_5-Sottoarea_32",2014,10,7,0,7
"443","Zona_3-Area_5-Sottoarea_32",2014,11,4,2,6
"444","Zona_3-Area_5-Sottoarea_32",2014,12,3,0,3
"445","Zona_3-Area_5-Sottoarea_32",2015,1,5,0,5
"446","Zona_3-Area_5-Sottoarea_32",2015,2,9,1,10
"447","Zona_3-Area_5-Sottoarea_32",2015,3,13,1,14
"448","Zona_3-Area_5-Sottoarea_32",2015,4,8,0,8
"449","Zona_3-Area_5-Sottoarea_32",2015,5,8,1,9
"450","Zona_3-Area_5-Sottoarea_32",2015,6,10,1,11
"451","Zona_3-Area_5-Sottoarea_32",2015,7,7,0,7
"452","Zona_3-Area_5-Sottoarea_32",2015,8,0,0,0
"453","Zona_3-Area_5-Sottoarea_32",2015,9,2,0,2
"454","Zona_3-Area_5-Sottoarea_32",2015,10,5,0,5
"455","Zona_3-Area_5-Sottoarea_32",2015,11,8,0,8
"456","Zona_3-Area_5-Sottoarea_32",2015,12,4,0,4
"457","Zona_3-Area_5-Sottoarea_32",2016,1,4,0,4
"458","Zona_3-Area_5-Sottoarea_32",2016,2,13,1,14
"459","Zona_3-Area_5-Sottoarea_32",2016,3,13,0,13
"460","Zona_3-Area_5-Sottoarea_32",2016,4,14,0,14
"461","Zona_3-Area_5-Sottoarea_32",2016,5,6,0,6
"462","Zona_3-Area_5-Sottoarea_32",2016,6,0,0,0
"463","Zona_3-Area_5-Sottoarea_32",2016,7,0,0,0
"464","Zona_3-Area_5-Sottoarea_32",2016,8,0,0,0
"465","Zona_3-Area_5-Sottoarea_32",2016,9,0,0,0
"466","Zona_3-Area_5-Sottoarea_32",2016,10,0,0,0
"467","Zona_3-Area_5-Sottoarea_32",2016,11,0,0,0
"468","Zona_3-Area_5-Sottoarea_32",2016,12,0,0,0
"469","Zona_3-Area_6-Sottoarea_33",2014,1,30,16,46
"470","Zona_3-Area_6-Sottoarea_33",2014,2,36,16,52
"471","Zona_3-Area_6-Sottoarea_33",2014,3,30,15,45
"472","Zona_3-Area_6-Sottoarea_33",2014,4,33,13,46
"473","Zona_3-Area_6-Sottoarea_33",2014,5,43,11,54
"474","Zona_3-Area_6-Sottoarea_33",2014,6,48,14,62
"475","Zona_3-Area_6-Sottoarea_33",2014,7,39,13,52
"476","Zona_3-Area_6-Sottoarea_33",2014,8,23,6,29
"477","Zona_3-Area_6-Sottoarea_33",2014,9,37,6,43
"478","Zona_3-Area_6-Sottoarea_33",2014,10,48,17,65
"479","Zona_3-Area_6-Sottoarea_33",2014,11,43,8,51
"480","Zona_3-Area_6-Sottoarea_33",2014,12,40,12,52
"481","Zona_3-Area_6-Sottoarea_33",2015,1,32,8,40
"482","Zona_3-Area_6-Sottoarea_33",2015,2,41,18,59
"483","Zona_3-Area_6-Sottoarea_33",2015,3,48,18,66
"484","Zona_3-Area_6-Sottoarea_33",2015,4,48,17,65
"485","Zona_3-Area_6-Sottoarea_33",2015,5,42,13,55
"486","Zona_3-Area_6-Sottoarea_33",2015,6,51,11,62
"487","Zona_3-Area_6-Sottoarea_33",2015,7,41,6,47
"488","Zona_3-Area_6-Sottoarea_33",2015,8,22,1,23
"489","Zona_3-Area_6-Sottoarea_33",2015,9,41,11,52
"490","Zona_3-Area_6-Sottoarea_33",2015,10,45,15,60
"491","Zona_3-Area_6-Sottoarea_33",2015,11,39,9,48
"492","Zona_3-Area_6-Sottoarea_33",2015,12,40,8,48
"493","Zona_3-Area_6-Sottoarea_33",2016,1,33,11,44
"494","Zona_3-Area_6-Sottoarea_33",2016,2,49,11,60
"495","Zona_3-Area_6-Sottoarea_33",2016,3,54,17,71
"496","Zona_3-Area_6-Sottoarea_33",2016,4,48,9,57
"497","Zona_3-Area_6-Sottoarea_33",2016,5,22,5,27
"498","Zona_3-Area_6-Sottoarea_33",2016,6,0,0,0
"499","Zona_3-Area_6-Sottoarea_33",2016,7,0,0,0
"500","Zona_3-Area_6-Sottoarea_33",2016,8,0,0,0
"501","Zona_3-Area_6-Sottoarea_33",2016,9,0,0,0
"502","Zona_3-Area_6-Sottoarea_33",2016,10,0,0,0
"503","Zona_3-Area_6-Sottoarea_33",2016,11,0,0,0
"504","Zona_3-Area_6-Sottoarea_33",2016,12,0,0,0
"505","Zona_3-Area_6-Sottoarea_34",2014,1,47,20,67
"506","Zona_3-Area_6-Sottoarea_34",2014,2,47,17,64
"507","Zona_3-Area_6-Sottoarea_34",2014,3,40,15,55
"508","Zona_3-Area_6-Sottoarea_34",2014,4,43,17,60
"509","Zona_3-Area_6-Sottoarea_34",2014,5,36,11,47
"510","Zona_3-Area_6-Sottoarea_34",2014,6,59,26,85
"511","Zona_3-Area_6-Sottoarea_34",2014,7,48,13,61
"512","Zona_3-Area_6-Sottoarea_34",2014,8,34,11,45
"513","Zona_3-Area_6-Sottoarea_34",2014,9,40,13,53
"514","Zona_3-Area_6-Sottoarea_34",2014,10,53,22,75
"515","Zona_3-Area_6-Sottoarea_34",2014,11,45,15,60
"516","Zona_3-Area_6-Sottoarea_34",2014,12,43,25,68
"517","Zona_3-Area_6-Sottoarea_34",2015,1,45,20,65
"518","Zona_3-Area_6-Sottoarea_34",2015,2,51,23,74
"519","Zona_3-Area_6-Sottoarea_34",2015,3,64,45,109
"520","Zona_3-Area_6-Sottoarea_34",2015,4,57,24,81
"521","Zona_3-Area_6-Sottoarea_34",2015,5,52,28,80
"522","Zona_3-Area_6-Sottoarea_34",2015,6,63,23,86
"523","Zona_3-Area_6-Sottoarea_34",2015,7,81,25,106
"524","Zona_3-Area_6-Sottoarea_34",2015,8,39,15,54
"525","Zona_3-Area_6-Sottoarea_34",2015,9,65,18,83
"526","Zona_3-Area_6-Sottoarea_34",2015,10,69,26,95
"527","Zona_3-Area_6-Sottoarea_34",2015,11,76,22,98
"528","Zona_3-Area_6-Sottoarea_34",2015,12,64,16,80
"529","Zona_3-Area_6-Sottoarea_34",2016,1,73,14,87
"530","Zona_3-Area_6-Sottoarea_34",2016,2,85,25,110
"531","Zona_3-Area_6-Sottoarea_34",2016,3,101,25,126
"532","Zona_3-Area_6-Sottoarea_34",2016,4,89,25,114
"533","Zona_3-Area_6-Sottoarea_34",2016,5,44,20,64
"534","Zona_3-Area_6-Sottoarea_34",2016,6,0,0,0
"535","Zona_3-Area_6-Sottoarea_34",2016,7,0,0,0
"536","Zona_3-Area_6-Sottoarea_34",2016,8,0,0,0
"537","Zona_3-Area_6-Sottoarea_34",2016,9,0,0,0
"538","Zona_3-Area_6-Sottoarea_34",2016,10,0,0,0
"539","Zona_3-Area_6-Sottoarea_34",2016,11,0,0,0
"540","Zona_3-Area_6-Sottoarea_34",2016,12,0,0,0
"541","Zona_3-Area_6-Sottoarea_35",2014,1,115,56,171
"542","Zona_3-Area_6-Sottoarea_35",2014,2,117,55,172
"543","Zona_3-Area_6-Sottoarea_35",2014,3,93,49,142
"544","Zona_3-Area_6-Sottoarea_35",2014,4,95,46,141
"545","Zona_3-Area_6-Sottoarea_35",2014,5,88,38,126
"546","Zona_3-Area_6-Sottoarea_35",2014,6,148,80,228
"547","Zona_3-Area_6-Sottoarea_35",2014,7,123,53,176
"548","Zona_3-Area_6-Sottoarea_35",2014,8,90,45,135
"549","Zona_3-Area_6-Sottoarea_35",2014,9,120,40,160
"550","Zona_3-Area_6-Sottoarea_35",2014,10,157,61,218
"551","Zona_3-Area_6-Sottoarea_35",2014,11,139,64,203
"552","Zona_3-Area_6-Sottoarea_35",2014,12,125,68,193
"553","Zona_3-Area_6-Sottoarea_35",2015,1,133,53,186
"554","Zona_3-Area_6-Sottoarea_35",2015,2,132,74,206
"555","Zona_3-Area_6-Sottoarea_35",2015,3,146,101,247
"556","Zona_3-Area_6-Sottoarea_35",2015,4,132,67,199
"557","Zona_3-Area_6-Sottoarea_35",2015,5,121,86,207
"558","Zona_3-Area_6-Sottoarea_35",2015,6,138,62,200
"559","Zona_3-Area_6-Sottoarea_35",2015,7,138,58,196
"560","Zona_3-Area_6-Sottoarea_35",2015,8,109,49,158
"561","Zona_3-Area_6-Sottoarea_35",2015,9,167,52,219
"562","Zona_3-Area_6-Sottoarea_35",2015,10,194,72,266
"563","Zona_3-Area_6-Sottoarea_35",2015,11,190,53,243
"564","Zona_3-Area_6-Sottoarea_35",2015,12,159,42,201
"565","Zona_3-Area_6-Sottoarea_35",2016,1,171,51,222
"566","Zona_3-Area_6-Sottoarea_35",2016,2,199,74,273
"567","Zona_3-Area_6-Sottoarea_35",2016,3,228,72,300
"568","Zona_3-Area_6-Sottoarea_35",2016,4,196,60,256
"569","Zona_3-Area_6-Sottoarea_35",2016,5,105,44,149
"570","Zona_3-Area_6-Sottoarea_35",2016,6,0,0,0
"571","Zona_3-Area_6-Sottoarea_35",2016,7,0,0,0
"572","Zona_3-Area_6-Sottoarea_35",2016,8,0,0,0
"573","Zona_3-Area_6-Sottoarea_35",2016,9,0,0,0
"574","Zona_3-Area_6-Sottoarea_35",2016,10,0,0,0
"575","Zona_3-Area_6-Sottoarea_35",2016,11,0,0,0
"576","Zona_3-Area_6-Sottoarea_35",2016,12,0,0,0
"577","Zona_4-Area_7-Sottoarea_36",2014,1,94,72,166
"578","Zona_4-Area_7-Sottoarea_36",2014,2,101,68,169
"579","Zona_4-Area_7-Sottoarea_36",2014,3,82,66,148
"580","Zona_4-Area_7-Sottoarea_36",2014,4,78,68,146
"581","Zona_4-Area_7-Sottoarea_36",2014,5,80,50,130
"582","Zona_4-Area_7-Sottoarea_36",2014,6,113,86,199
"583","Zona_4-Area_7-Sottoarea_36",2014,7,94,74,168
"584","Zona_4-Area_7-Sottoarea_36",2014,8,78,54,132
"585","Zona_4-Area_7-Sottoarea_36",2014,9,93,50,143
"586","Zona_4-Area_7-Sottoarea_36",2014,10,108,76,184
"587","Zona_4-Area_7-Sottoarea_36",2014,11,89,68,157
"588","Zona_4-Area_7-Sottoarea_36",2014,12,84,68,152
"589","Zona_4-Area_7-Sottoarea_36",2015,1,91,62,153
"590","Zona_4-Area_7-Sottoarea_36",2015,2,98,77,175
"591","Zona_4-Area_7-Sottoarea_36",2015,3,114,87,201
"592","Zona_4-Area_7-Sottoarea_36",2015,4,106,69,175
"593","Zona_4-Area_7-Sottoarea_36",2015,5,95,70,165
"594","Zona_4-Area_7-Sottoarea_36",2015,6,122,53,175
"595","Zona_4-Area_7-Sottoarea_36",2015,7,117,55,172
"596","Zona_4-Area_7-Sottoarea_36",2015,8,79,40,119
"597","Zona_4-Area_7-Sottoarea_36",2015,9,136,51,187
"598","Zona_4-Area_7-Sottoarea_36",2015,10,140,70,210
"599","Zona_4-Area_7-Sottoarea_36",2015,11,140,62,202
"600","Zona_4-Area_7-Sottoarea_36",2015,12,114,54,168
"601","Zona_4-Area_7-Sottoarea_36",2016,1,110,53,163
"602","Zona_4-Area_7-Sottoarea_36",2016,2,141,68,209
"603","Zona_4-Area_7-Sottoarea_36",2016,3,147,78,225
"604","Zona_4-Area_7-Sottoarea_36",2016,4,134,72,206
"605","Zona_4-Area_7-Sottoarea_36",2016,5,80,46,126
"606","Zona_4-Area_7-Sottoarea_36",2016,6,0,0,0
"607","Zona_4-Area_7-Sottoarea_36",2016,7,0,0,0
"608","Zona_4-Area_7-Sottoarea_36",2016,8,0,0,0
"609","Zona_4-Area_7-Sottoarea_36",2016,9,0,0,0
"610","Zona_4-Area_7-Sottoarea_36",2016,10,0,0,0
"611","Zona_4-Area_7-Sottoarea_36",2016,11,0,0,0
"612","Zona_4-Area_7-Sottoarea_36",2016,12,0,0,0
"613","Zona_4-Area_7-Sottoarea_37",2014,1,262,153,415
"614","Zona_4-Area_7-Sottoarea_37",2014,2,263,174,437
"615","Zona_4-Area_7-Sottoarea_37",2014,3,210,135,345
"616","Zona_4-Area_7-Sottoarea_37",2014,4,205,124,329
"617","Zona_4-Area_7-Sottoarea_37",2014,5,184,116,300
"618","Zona_4-Area_7-Sottoarea_37",2014,6,260,181,441
"619","Zona_4-Area_7-Sottoarea_37",2014,7,238,149,387
"620","Zona_4-Area_7-Sottoarea_37",2014,8,166,106,272
"621","Zona_4-Area_7-Sottoarea_37",2014,9,238,109,347
"622","Zona_4-Area_7-Sottoarea_37",2014,10,262,163,425
"623","Zona_4-Area_7-Sottoarea_37",2014,11,248,157,405
"624","Zona_4-Area_7-Sottoarea_37",2014,12,246,144,390
"625","Zona_4-Area_7-Sottoarea_37",2015,1,261,136,397
"626","Zona_4-Area_7-Sottoarea_37",2015,2,276,167,443
"627","Zona_4-Area_7-Sottoarea_37",2015,3,289,192,481
"628","Zona_4-Area_7-Sottoarea_37",2015,4,287,180,467
"629","Zona_4-Area_7-Sottoarea_37",2015,5,248,171,419
"630","Zona_4-Area_7-Sottoarea_37",2015,6,304,138,442
"631","Zona_4-Area_7-Sottoarea_37",2015,7,282,135,417
"632","Zona_4-Area_7-Sottoarea_37",2015,8,215,111,326
"633","Zona_4-Area_7-Sottoarea_37",2015,9,342,141,483
"634","Zona_4-Area_7-Sottoarea_37",2015,10,343,166,509
"635","Zona_4-Area_7-Sottoarea_37",2015,11,349,138,487
"636","Zona_4-Area_7-Sottoarea_37",2015,12,306,111,417
"637","Zona_4-Area_7-Sottoarea_37",2016,1,283,123,406
"638","Zona_4-Area_7-Sottoarea_37",2016,2,350,159,509
"639","Zona_4-Area_7-Sottoarea_37",2016,3,367,202,569
"640","Zona_4-Area_7-Sottoarea_37",2016,4,339,185,524
"641","Zona_4-Area_7-Sottoarea_37",2016,5,207,112,319
"642","Zona_4-Area_7-Sottoarea_37",2016,6,0,0,0
"643","Zona_4-Area_7-Sottoarea_37",2016,7,0,0,0
"644","Zona_4-Area_7-Sottoarea_37",2016,8,0,0,0
"645","Zona_4-Area_7-Sottoarea_37",2016,9,0,0,0
"646","Zona_4-Area_7-Sottoarea_37",2016,10,0,0,0
"647","Zona_4-Area_7-Sottoarea_37",2016,11,0,0,0
"648","Zona_4-Area_7-Sottoarea_37",2016,12,0,0,0
"649","Zona_4-Area_8-Sottoarea_38",2014,1,54,27,81
"650","Zona_4-Area_8-Sottoarea_38",2014,2,59,28,87
"651","Zona_4-Area_8-Sottoarea_38",2014,3,43,26,69
"652","Zona_4-Area_8-Sottoarea_38",2014,4,44,25,69
"653","Zona_4-Area_8-Sottoarea_38",2014,5,45,19,64
"654","Zona_4-Area_8-Sottoarea_38",2014,6,61,38,99
"655","Zona_4-Area_8-Sottoarea_38",2014,7,45,28,73
"656","Zona_4-Area_8-Sottoarea_38",2014,8,36,22,58
"657","Zona_4-Area_8-Sottoarea_38",2014,9,52,25,77
"658","Zona_4-Area_8-Sottoarea_38",2014,10,59,31,90
"659","Zona_4-Area_8-Sottoarea_38",2014,11,52,28,80
"660","Zona_4-Area_8-Sottoarea_38",2014,12,42,27,69
"661","Zona_4-Area_8-Sottoarea_38",2015,1,45,25,70
"662","Zona_4-Area_8-Sottoarea_38",2015,2,54,33,87
"663","Zona_4-Area_8-Sottoarea_38",2015,3,59,44,103
"664","Zona_4-Area_8-Sottoarea_38",2015,4,65,60,125
"665","Zona_4-Area_8-Sottoarea_38",2015,5,50,42,92
"666","Zona_4-Area_8-Sottoarea_38",2015,6,59,26,85
"667","Zona_4-Area_8-Sottoarea_38",2015,7,59,29,88
"668","Zona_4-Area_8-Sottoarea_38",2015,8,42,23,65
"669","Zona_4-Area_8-Sottoarea_38",2015,9,64,32,96
"670","Zona_4-Area_8-Sottoarea_38",2015,10,64,35,99
"671","Zona_4-Area_8-Sottoarea_38",2015,11,68,29,97
"672","Zona_4-Area_8-Sottoarea_38",2015,12,72,29,101
"673","Zona_4-Area_8-Sottoarea_38",2016,1,79,31,110
"674","Zona_4-Area_8-Sottoarea_38",2016,2,101,32,133
"675","Zona_4-Area_8-Sottoarea_38",2016,3,100,41,141
"676","Zona_4-Area_8-Sottoarea_38",2016,4,84,32,116
"677","Zona_4-Area_8-Sottoarea_38",2016,5,49,19,68
"678","Zona_4-Area_8-Sottoarea_38",2016,6,0,0,0
"679","Zona_4-Area_8-Sottoarea_38",2016,7,0,0,0
"680","Zona_4-Area_8-Sottoarea_38",2016,8,0,0,0
"681","Zona_4-Area_8-Sottoarea_38",2016,9,0,0,0
"682","Zona_4-Area_8-Sottoarea_38",2016,10,0,0,0
"683","Zona_4-Area_8-Sottoarea_38",2016,11,0,0,0
"684","Zona_4-Area_8-Sottoarea_38",2016,12,0,0,0
"685","Zona_4-Area_8-Sottoarea_39",2014,1,86,55,141
"686","Zona_4-Area_8-Sottoarea_39",2014,2,102,62,164
"687","Zona_4-Area_8-Sottoarea_39",2014,3,75,47,122
"688","Zona_4-Area_8-Sottoarea_39",2014,4,79,54,133
"689","Zona_4-Area_8-Sottoarea_39",2014,5,80,45,125
"690","Zona_4-Area_8-Sottoarea_39",2014,6,109,65,174
"691","Zona_4-Area_8-Sottoarea_39",2014,7,92,53,145
"692","Zona_4-Area_8-Sottoarea_39",2014,8,88,51,139
"693","Zona_4-Area_8-Sottoarea_39",2014,9,114,47,161
"694","Zona_4-Area_8-Sottoarea_39",2014,10,141,66,207
"695","Zona_4-Area_8-Sottoarea_39",2014,11,119,56,175
"696","Zona_4-Area_8-Sottoarea_39",2014,12,110,62,172
"697","Zona_4-Area_8-Sottoarea_39",2015,1,106,49,155
"698","Zona_4-Area_8-Sottoarea_39",2015,2,130,71,201
"699","Zona_4-Area_8-Sottoarea_39",2015,3,125,70,195
"700","Zona_4-Area_8-Sottoarea_39",2015,4,121,64,185
"701","Zona_4-Area_8-Sottoarea_39",2015,5,107,67,174
"702","Zona_4-Area_8-Sottoarea_39",2015,6,134,76,210
"703","Zona_4-Area_8-Sottoarea_39",2015,7,132,78,210
"704","Zona_4-Area_8-Sottoarea_39",2015,8,90,45,135
"705","Zona_4-Area_8-Sottoarea_39",2015,9,154,60,214
"706","Zona_4-Area_8-Sottoarea_39",2015,10,155,65,220
"707","Zona_4-Area_8-Sottoarea_39",2015,11,157,59,216
"708","Zona_4-Area_8-Sottoarea_39",2015,12,138,54,192
"709","Zona_4-Area_8-Sottoarea_39",2016,1,143,53,196
"710","Zona_4-Area_8-Sottoarea_39",2016,2,174,85,259
"711","Zona_4-Area_8-Sottoarea_39",2016,3,170,110,280
"712","Zona_4-Area_8-Sottoarea_39",2016,4,159,69,228
"713","Zona_4-Area_8-Sottoarea_39",2016,5,92,43,135
"714","Zona_4-Area_8-Sottoarea_39",2016,6,0,0,0
"715","Zona_4-Area_8-Sottoarea_39",2016,7,0,0,0
"716","Zona_4-Area_8-Sottoarea_39",2016,8,0,0,0
"717","Zona_4-Area_8-Sottoarea_39",2016,9,0,0,0
"718","Zona_4-Area_8-Sottoarea_39",2016,10,0,0,0
"719","Zona_4-Area_8-Sottoarea_39",2016,11,0,0,0
"720","Zona_4-Area_8-Sottoarea_39",2016,12,0,0,0
"721","Zona_4-Area_8-Sottoarea_40",2014,1,129,75,204
"722","Zona_4-Area_8-Sottoarea_40",2014,2,132,79,211
"723","Zona_4-Area_8-Sottoarea_40",2014,3,97,68,165
"724","Zona_4-Area_8-Sottoarea_40",2014,4,122,80,202
"725","Zona_4-Area_8-Sottoarea_40",2014,5,123,73,196
"726","Zona_4-Area_8-Sottoarea_40",2014,6,125,72,197
"727","Zona_4-Area_8-Sottoarea_40",2014,7,133,73,206
"728","Zona_4-Area_8-Sottoarea_40",2014,8,98,64,162
"729","Zona_4-Area_8-Sottoarea_40",2014,9,133,61,194
"730","Zona_4-Area_8-Sottoarea_40",2014,10,155,92,247
"731","Zona_4-Area_8-Sottoarea_40",2014,11,147,88,235
"732","Zona_4-Area_8-Sottoarea_40",2014,12,128,93,221
"733","Zona_4-Area_8-Sottoarea_40",2015,1,126,67,193
"734","Zona_4-Area_8-Sottoarea_40",2015,2,144,100,244
"735","Zona_4-Area_8-Sottoarea_40",2015,3,161,118,279
"736","Zona_4-Area_8-Sottoarea_40",2015,4,148,101,249
"737","Zona_4-Area_8-Sottoarea_40",2015,5,146,99,245
"738","Zona_4-Area_8-Sottoarea_40",2015,6,166,83,249
"739","Zona_4-Area_8-Sottoarea_40",2015,7,163,86,249
"740","Zona_4-Area_8-Sottoarea_40",2015,8,119,61,180
"741","Zona_4-Area_8-Sottoarea_40",2015,9,171,89,260
"742","Zona_4-Area_8-Sottoarea_40",2015,10,186,117,303
"743","Zona_4-Area_8-Sottoarea_40",2015,11,179,100,279
"744","Zona_4-Area_8-Sottoarea_40",2015,12,165,122,287
"745","Zona_4-Area_8-Sottoarea_40",2016,1,164,89,253
"746","Zona_4-Area_8-Sottoarea_40",2016,2,199,106,305
"747","Zona_4-Area_8-Sottoarea_40",2016,3,213,125,338
"748","Zona_4-Area_8-Sottoarea_40",2016,4,194,103,297
"749","Zona_4-Area_8-Sottoarea_40",2016,5,118,67,185
"750","Zona_4-Area_8-Sottoarea_40",2016,6,0,0,0
"751","Zona_4-Area_8-Sottoarea_40",2016,7,0,0,0
"752","Zona_4-Area_8-Sottoarea_40",2016,8,0,0,0
"753","Zona_4-Area_8-Sottoarea_40",2016,9,0,0,0
"754","Zona_4-Area_8-Sottoarea_40",2016,10,0,0,0
"755","Zona_4-Area_8-Sottoarea_40",2016,11,0,0,0
"756","Zona_4-Area_8-Sottoarea_40",2016,12,0,0,0
"757","Zona_5-Area_9-Sottoarea_80",2014,1,96,42,138
"758","Zona_5-Area_9-Sottoarea_80",2014,2,91,40,131
"759","Zona_5-Area_9-Sottoarea_80",2014,3,81,36,117
"760","Zona_5-Area_9-Sottoarea_80",2014,4,98,38,136
"761","Zona_5-Area_9-Sottoarea_80",2014,5,90,50,140
"762","Zona_5-Area_9-Sottoarea_80",2014,6,90,44,134
"763","Zona_5-Area_9-Sottoarea_80",2014,7,105,47,152
"764","Zona_5-Area_9-Sottoarea_80",2014,8,85,33,118
"765","Zona_5-Area_9-Sottoarea_80",2014,9,111,26,137
"766","Zona_5-Area_9-Sottoarea_80",2014,10,123,42,165
"767","Zona_5-Area_9-Sottoarea_80",2014,11,105,37,142
"768","Zona_5-Area_9-Sottoarea_80",2014,12,93,48,141
"769","Zona_5-Area_9-Sottoarea_80",2015,1,120,33,153
"770","Zona_5-Area_9-Sottoarea_80",2015,2,112,45,157
"771","Zona_5-Area_9-Sottoarea_80",2015,3,119,77,196
"772","Zona_5-Area_9-Sottoarea_80",2015,4,110,69,179
"773","Zona_5-Area_9-Sottoarea_80",2015,5,117,51,168
"774","Zona_5-Area_9-Sottoarea_80",2015,6,121,71,192
"775","Zona_5-Area_9-Sottoarea_80",2015,7,109,55,164
"776","Zona_5-Area_9-Sottoarea_80",2015,8,85,32,117
"777","Zona_5-Area_9-Sottoarea_80",2015,9,114,55,169
"778","Zona_5-Area_9-Sottoarea_80",2015,10,118,53,171
"779","Zona_5-Area_9-Sottoarea_80",2015,11,126,40,166
"780","Zona_5-Area_9-Sottoarea_80",2015,12,116,38,154
"781","Zona_5-Area_9-Sottoarea_80",2016,1,128,36,164
"782","Zona_5-Area_9-Sottoarea_80",2016,2,156,50,206
"783","Zona_5-Area_9-Sottoarea_80",2016,3,159,68,227
"784","Zona_5-Area_9-Sottoarea_80",2016,4,146,47,193
"785","Zona_5-Area_9-Sottoarea_80",2016,5,87,34,121
"786","Zona_5-Area_9-Sottoarea_80",2016,6,0,0,0
"787","Zona_5-Area_9-Sottoarea_80",2016,7,0,0,0
"788","Zona_5-Area_9-Sottoarea_80",2016,8,0,0,0
"789","Zona_5-Area_9-Sottoarea_80",2016,9,0,0,0
"790","Zona_5-Area_9-Sottoarea_80",2016,10,0,0,0
"791","Zona_5-Area_9-Sottoarea_80",2016,11,0,0,0
"792","Zona_5-Area_9-Sottoarea_80",2016,12,0,0,0
"793","Zona_5-Area_9-Sottoarea_81",2014,1,75,30,105
"794","Zona_5-Area_9-Sottoarea_81",2014,2,76,37,113
"795","Zona_5-Area_9-Sottoarea_81",2014,3,60,28,88
"796","Zona_5-Area_9-Sottoarea_81",2014,4,76,34,110
"797","Zona_5-Area_9-Sottoarea_81",2014,5,72,32,104
"798","Zona_5-Area_9-Sottoarea_81",2014,6,67,32,99
"799","Zona_5-Area_9-Sottoarea_81",2014,7,79,50,129
"800","Zona_5-Area_9-Sottoarea_81",2014,8,74,23,97
"801","Zona_5-Area_9-Sottoarea_81",2014,9,101,18,119
"802","Zona_5-Area_9-Sottoarea_81",2014,10,125,34,159
"803","Zona_5-Area_9-Sottoarea_81",2014,11,123,37,160
"804","Zona_5-Area_9-Sottoarea_81",2014,12,78,53,131
"805","Zona_5-Area_9-Sottoarea_81",2015,1,96,41,137
"806","Zona_5-Area_9-Sottoarea_81",2015,2,90,49,139
"807","Zona_5-Area_9-Sottoarea_81",2015,3,99,56,155
"808","Zona_5-Area_9-Sottoarea_81",2015,4,98,47,145
"809","Zona_5-Area_9-Sottoarea_81",2015,5,90,34,124
"810","Zona_5-Area_9-Sottoarea_81",2015,6,88,41,129
"811","Zona_5-Area_9-Sottoarea_81",2015,7,84,38,122
"812","Zona_5-Area_9-Sottoarea_81",2015,8,70,28,98
"813","Zona_5-Area_9-Sottoarea_81",2015,9,93,32,125
"814","Zona_5-Area_9-Sottoarea_81",2015,10,105,39,144
"815","Zona_5-Area_9-Sottoarea_81",2015,11,100,28,128
"816","Zona_5-Area_9-Sottoarea_81",2015,12,92,31,123
"817","Zona_5-Area_9-Sottoarea_81",2016,1,105,38,143
"818","Zona_5-Area_9-Sottoarea_81",2016,2,112,45,157
"819","Zona_5-Area_9-Sottoarea_81",2016,3,111,57,168
"820","Zona_5-Area_9-Sottoarea_81",2016,4,106,40,146
"821","Zona_5-Area_9-Sottoarea_81",2016,5,67,27,94
"822","Zona_5-Area_9-Sottoarea_81",2016,6,0,0,0
"823","Zona_5-Area_9-Sottoarea_81",2016,7,0,0,0
"824","Zona_5-Area_9-Sottoarea_81",2016,8,0,0,0
"825","Zona_5-Area_9-Sottoarea_81",2016,9,0,0,0
"826","Zona_5-Area_9-Sottoarea_81",2016,10,0,0,0
"827","Zona_5-Area_9-Sottoarea_81",2016,11,0,0,0
"828","Zona_5-Area_9-Sottoarea_81",2016,12,0,0,0
"829","Zona_5-Area_9-Sottoarea_82",2014,1,56,23,79
"830","Zona_5-Area_9-Sottoarea_82",2014,2,52,24,76
"831","Zona_5-Area_9-Sottoarea_82",2014,3,48,20,68
"832","Zona_5-Area_9-Sottoarea_82",2014,4,61,20,81
"833","Zona_5-Area_9-Sottoarea_82",2014,5,52,22,74
"834","Zona_5-Area_9-Sottoarea_82",2014,6,53,18,71
"835","Zona_5-Area_9-Sottoarea_82",2014,7,57,16,73
"836","Zona_5-Area_9-Sottoarea_82",2014,8,38,18,56
"837","Zona_5-Area_9-Sottoarea_82",2014,9,56,18,74
"838","Zona_5-Area_9-Sottoarea_82",2014,10,58,27,85
"839","Zona_5-Area_9-Sottoarea_82",2014,11,54,18,72
"840","Zona_5-Area_9-Sottoarea_82",2014,12,50,21,71
"841","Zona_5-Area_9-Sottoarea_82",2015,1,67,43,110
"842","Zona_5-Area_9-Sottoarea_82",2015,2,58,26,84
"843","Zona_5-Area_9-Sottoarea_82",2015,3,64,26,90
"844","Zona_5-Area_9-Sottoarea_82",2015,4,57,30,87
"845","Zona_5-Area_9-Sottoarea_82",2015,5,54,29,83
"846","Zona_5-Area_9-Sottoarea_82",2015,6,61,22,83
"847","Zona_5-Area_9-Sottoarea_82",2015,7,54,24,78
"848","Zona_5-Area_9-Sottoarea_82",2015,8,48,16,64
"849","Zona_5-Area_9-Sottoarea_82",2015,9,57,23,80
"850","Zona_5-Area_9-Sottoarea_82",2015,10,62,29,91
"851","Zona_5-Area_9-Sottoarea_82",2015,11,62,21,83
"852","Zona_5-Area_9-Sottoarea_82",2015,12,55,21,76
"853","Zona_5-Area_9-Sottoarea_82",2016,1,60,21,81
"854","Zona_5-Area_9-Sottoarea_82",2016,2,71,29,100
"855","Zona_5-Area_9-Sottoarea_82",2016,3,73,35,108
"856","Zona_5-Area_9-Sottoarea_82",2016,4,57,22,79
"857","Zona_5-Area_9-Sottoarea_82",2016,5,33,14,47
"858","Zona_5-Area_9-Sottoarea_82",2016,6,0,0,0
"859","Zona_5-Area_9-Sottoarea_82",2016,7,0,0,0
"860","Zona_5-Area_9-Sottoarea_82",2016,8,0,0,0
"861","Zona_5-Area_9-Sottoarea_82",2016,9,0,0,0
"862","Zona_5-Area_9-Sottoarea_82",2016,10,0,0,0
"863","Zona_5-Area_9-Sottoarea_82",2016,11,0,0,0
"864","Zona_5-Area_9-Sottoarea_82",2016,12,0,0,0
"865","Zona_5-Area_10-Sottoarea_96",2014,1,110,49,159
"866","Zona_5-Area_10-Sottoarea_96",2014,2,109,44,153
"867","Zona_5-Area_10-Sottoarea_96",2014,3,91,39,130
"868","Zona_5-Area_10-Sottoarea_96",2014,4,104,42,146
"869","Zona_5-Area_10-Sottoarea_96",2014,5,115,34,149
"870","Zona_5-Area_10-Sottoarea_96",2014,6,108,42,150
"871","Zona_5-Area_10-Sottoarea_96",2014,7,118,41,159
"872","Zona_5-Area_10-Sottoarea_96",2014,8,84,32,116
"873","Zona_5-Area_10-Sottoarea_96",2014,9,149,34,183
"874","Zona_5-Area_10-Sottoarea_96",2014,10,163,62,225
"875","Zona_5-Area_10-Sottoarea_96",2014,11,160,61,221
"876","Zona_5-Area_10-Sottoarea_96",2014,12,162,63,225
"877","Zona_5-Area_10-Sottoarea_96",2015,1,158,49,207
"878","Zona_5-Area_10-Sottoarea_96",2015,2,162,58,220
"879","Zona_5-Area_10-Sottoarea_96",2015,3,173,95,268
"880","Zona_5-Area_10-Sottoarea_96",2015,4,150,97,247
"881","Zona_5-Area_10-Sottoarea_96",2015,5,169,86,255
"882","Zona_5-Area_10-Sottoarea_96",2015,6,166,116,282
"883","Zona_5-Area_10-Sottoarea_96",2015,7,151,111,262
"884","Zona_5-Area_10-Sottoarea_96",2015,8,120,79,199
"885","Zona_5-Area_10-Sottoarea_96",2015,9,167,111,278
"886","Zona_5-Area_10-Sottoarea_96",2015,10,185,94,279
"887","Zona_5-Area_10-Sottoarea_96",2015,11,171,84,255
"888","Zona_5-Area_10-Sottoarea_96",2015,12,151,65,216
"889","Zona_5-Area_10-Sottoarea_96",2016,1,147,54,201
"890","Zona_5-Area_10-Sottoarea_96",2016,2,166,85,251
"891","Zona_5-Area_10-Sottoarea_96",2016,3,185,103,288
"892","Zona_5-Area_10-Sottoarea_96",2016,4,148,70,218
"893","Zona_5-Area_10-Sottoarea_96",2016,5,98,58,156
"894","Zona_5-Area_10-Sottoarea_96",2016,6,0,0,0
"895","Zona_5-Area_10-Sottoarea_96",2016,7,0,0,0
"896","Zona_5-Area_10-Sottoarea_96",2016,8,0,0,0
"897","Zona_5-Area_10-Sottoarea_96",2016,9,0,0,0
"898","Zona_5-Area_10-Sottoarea_96",2016,10,0,0,0
"899","Zona_5-Area_10-Sottoarea_96",2016,11,0,0,0
"900","Zona_5-Area_10-Sottoarea_96",2016,12,0,0,0
"901","Zona_5-Area_10-Sottoarea_97",2014,1,80,33,113
"902","Zona_5-Area_10-Sottoarea_97",2014,2,75,32,107
"903","Zona_5-Area_10-Sottoarea_97",2014,3,57,29,86
"904","Zona_5-Area_10-Sottoarea_97",2014,4,73,29,102
"905","Zona_5-Area_10-Sottoarea_97",2014,5,84,25,109
"906","Zona_5-Area_10-Sottoarea_97",2014,6,78,25,103
"907","Zona_5-Area_10-Sottoarea_97",2014,7,80,27,107
"908","Zona_5-Area_10-Sottoarea_97",2014,8,57,18,75
"909","Zona_5-Area_10-Sottoarea_97",2014,9,92,30,122
"910","Zona_5-Area_10-Sottoarea_97",2014,10,106,38,144
"911","Zona_5-Area_10-Sottoarea_97",2014,11,101,34,135
"912","Zona_5-Area_10-Sottoarea_97",2014,12,105,29,134
"913","Zona_5-Area_10-Sottoarea_97",2015,1,104,36,140
"914","Zona_5-Area_10-Sottoarea_97",2015,2,104,43,147
"915","Zona_5-Area_10-Sottoarea_97",2015,3,118,73,191
"916","Zona_5-Area_10-Sottoarea_97",2015,4,98,53,151
"917","Zona_5-Area_10-Sottoarea_97",2015,5,93,52,145
"918","Zona_5-Area_10-Sottoarea_97",2015,6,103,38,141
"919","Zona_5-Area_10-Sottoarea_97",2015,7,91,36,127
"920","Zona_5-Area_10-Sottoarea_97",2015,8,76,29,105
"921","Zona_5-Area_10-Sottoarea_97",2015,9,91,42,133
"922","Zona_5-Area_10-Sottoarea_97",2015,10,102,41,143
"923","Zona_5-Area_10-Sottoarea_97",2015,11,95,40,135
"924","Zona_5-Area_10-Sottoarea_97",2015,12,88,31,119
"925","Zona_5-Area_10-Sottoarea_97",2016,1,95,31,126
"926","Zona_5-Area_10-Sottoarea_97",2016,2,108,45,153
"927","Zona_5-Area_10-Sottoarea_97",2016,3,107,47,154
"928","Zona_5-Area_10-Sottoarea_97",2016,4,91,36,127
"929","Zona_5-Area_10-Sottoarea_97",2016,5,56,27,83
"930","Zona_5-Area_10-Sottoarea_97",2016,6,0,0,0
"931","Zona_5-Area_10-Sottoarea_97",2016,7,0,0,0
"932","Zona_5-Area_10-Sottoarea_97",2016,8,0,0,0
"933","Zona_5-Area_10-Sottoarea_97",2016,9,0,0,0
"934","Zona_5-Area_10-Sottoarea_97",2016,10,0,0,0
"935","Zona_5-Area_10-Sottoarea_97",2016,11,0,0,0
"936","Zona_5-Area_10-Sottoarea_97",2016,12,0,0,0
"937","Zona_5-Area_11-Sottoarea_105",2014,1,211,86,297
"938","Zona_5-Area_11-Sottoarea_105",2014,2,195,90,285
"939","Zona_5-Area_11-Sottoarea_105",2014,3,150,82,232
"940","Zona_5-Area_11-Sottoarea_105",2014,4,182,74,256
"941","Zona_5-Area_11-Sottoarea_105",2014,5,189,79,268
"942","Zona_5-Area_11-Sottoarea_105",2014,6,178,64,242
"943","Zona_5-Area_11-Sottoarea_105",2014,7,184,65,249
"944","Zona_5-Area_11-Sottoarea_105",2014,8,153,51,204
"945","Zona_5-Area_11-Sottoarea_105",2014,9,201,46,247
"946","Zona_5-Area_11-Sottoarea_105",2014,10,228,78,306
"947","Zona_5-Area_11-Sottoarea_105",2014,11,211,74,285
"948","Zona_5-Area_11-Sottoarea_105",2014,12,187,90,277
"949","Zona_5-Area_11-Sottoarea_105",2015,1,226,71,297
"950","Zona_5-Area_11-Sottoarea_105",2015,2,192,99,291
"951","Zona_5-Area_11-Sottoarea_105",2015,3,216,145,361
"952","Zona_5-Area_11-Sottoarea_105",2015,4,192,110,302
"953","Zona_5-Area_11-Sottoarea_105",2015,5,204,85,289
"954","Zona_5-Area_11-Sottoarea_105",2015,6,203,89,292
"955","Zona_5-Area_11-Sottoarea_105",2015,7,191,85,276
"956","Zona_5-Area_11-Sottoarea_105",2015,8,151,51,202
"957","Zona_5-Area_11-Sottoarea_105",2015,9,200,85,285
"958","Zona_5-Area_11-Sottoarea_105",2015,10,220,97,317
"959","Zona_5-Area_11-Sottoarea_105",2015,11,204,91,295
"960","Zona_5-Area_11-Sottoarea_105",2015,12,189,82,271
"961","Zona_5-Area_11-Sottoarea_105",2016,1,218,84,302
"962","Zona_5-Area_11-Sottoarea_105",2016,2,232,118,350
"963","Zona_5-Area_11-Sottoarea_105",2016,3,241,136,377
"964","Zona_5-Area_11-Sottoarea_105",2016,4,214,98,312
"965","Zona_5-Area_11-Sottoarea_105",2016,5,127,80,207
"966","Zona_5-Area_11-Sottoarea_105",2016,6,0,0,0
"967","Zona_5-Area_11-Sottoarea_105",2016,7,0,0,0
"968","Zona_5-Area_11-Sottoarea_105",2016,8,0,0,0
"969","Zona_5-Area_11-Sottoarea_105",2016,9,0,0,0
"970","Zona_5-Area_11-Sottoarea_105",2016,10,0,0,0
"971","Zona_5-Area_11-Sottoarea_105",2016,11,0,0,0
"972","Zona_5-Area_11-Sottoarea_105",2016,12,0,0,0
"973","Zona_6-Area_12-Sottoarea_24",2014,1,159,58,217
"974","Zona_6-Area_12-Sottoarea_24",2014,2,186,73,259
"975","Zona_6-Area_12-Sottoarea_24",2014,3,149,76,225
"976","Zona_6-Area_12-Sottoarea_24",2014,4,185,95,280
"977","Zona_6-Area_12-Sottoarea_24",2014,5,187,87,274
"978","Zona_6-Area_12-Sottoarea_24",2014,6,183,83,266
"979","Zona_6-Area_12-Sottoarea_24",2014,7,163,104,267
"980","Zona_6-Area_12-Sottoarea_24",2014,8,117,70,187
"981","Zona_6-Area_12-Sottoarea_24",2014,9,202,75,277
"982","Zona_6-Area_12-Sottoarea_24",2014,10,245,80,325
"983","Zona_6-Area_12-Sottoarea_24",2014,11,229,82,311
"984","Zona_6-Area_12-Sottoarea_24",2014,12,191,73,264
"985","Zona_6-Area_12-Sottoarea_24",2015,1,195,94,289
"986","Zona_6-Area_12-Sottoarea_24",2015,2,189,86,275
"987","Zona_6-Area_12-Sottoarea_24",2015,3,216,115,331
"988","Zona_6-Area_12-Sottoarea_24",2015,4,200,89,289
"989","Zona_6-Area_12-Sottoarea_24",2015,5,178,69,247
"990","Zona_6-Area_12-Sottoarea_24",2015,6,190,72,262
"991","Zona_6-Area_12-Sottoarea_24",2015,7,173,64,237
"992","Zona_6-Area_12-Sottoarea_24",2015,8,129,43,172
"993","Zona_6-Area_12-Sottoarea_24",2015,9,221,62,283
"994","Zona_6-Area_12-Sottoarea_24",2015,10,247,64,311
"995","Zona_6-Area_12-Sottoarea_24",2015,11,203,61,264
"996","Zona_6-Area_12-Sottoarea_24",2015,12,167,50,217
"997","Zona_6-Area_12-Sottoarea_24",2016,1,174,46,220
"998","Zona_6-Area_12-Sottoarea_24",2016,2,186,64,250
"999","Zona_6-Area_12-Sottoarea_24",2016,3,185,75,260
"1000","Zona_6-Area_12-Sottoarea_24",2016,4,182,65,247
"1001","Zona_6-Area_12-Sottoarea_24",2016,5,100,33,133
"1002","Zona_6-Area_12-Sottoarea_24",2016,6,0,0,0
"1003","Zona_6-Area_12-Sottoarea_24",2016,7,0,0,0
"1004","Zona_6-Area_12-Sottoarea_24",2016,8,0,0,0
"1005","Zona_6-Area_12-Sottoarea_24",2016,9,0,0,0
"1006","Zona_6-Area_12-Sottoarea_24",2016,10,0,0,0
"1007","Zona_6-Area_12-Sottoarea_24",2016,11,0,0,0
"1008","Zona_6-Area_12-Sottoarea_24",2016,12,0,0,0
"1009","Zona_6-Area_12-Sottoarea_25",2014,1,137,65,202
"1010","Zona_6-Area_12-Sottoarea_25",2014,2,142,73,215
"1011","Zona_6-Area_12-Sottoarea_25",2014,3,127,69,196
"1012","Zona_6-Area_12-Sottoarea_25",2014,4,144,64,208
"1013","Zona_6-Area_12-Sottoarea_25",2014,5,150,60,210
"1014","Zona_6-Area_12-Sottoarea_25",2014,6,141,53,194
"1015","Zona_6-Area_12-Sottoarea_25",2014,7,149,62,211
"1016","Zona_6-Area_12-Sottoarea_25",2014,8,112,48,160
"1017","Zona_6-Area_12-Sottoarea_25",2014,9,156,46,202
"1018","Zona_6-Area_12-Sottoarea_25",2014,10,180,62,242
"1019","Zona_6-Area_12-Sottoarea_25",2014,11,165,56,221
"1020","Zona_6-Area_12-Sottoarea_25",2014,12,169,72,241
"1021","Zona_6-Area_12-Sottoarea_25",2015,1,194,99,293
"1022","Zona_6-Area_12-Sottoarea_25",2015,2,177,80,257
"1023","Zona_6-Area_12-Sottoarea_25",2015,3,210,108,318
"1024","Zona_6-Area_12-Sottoarea_25",2015,4,171,97,268
"1025","Zona_6-Area_12-Sottoarea_25",2015,5,160,64,224
"1026","Zona_6-Area_12-Sottoarea_25",2015,6,160,59,219
"1027","Zona_6-Area_12-Sottoarea_25",2015,7,140,67,207
"1028","Zona_6-Area_12-Sottoarea_25",2015,8,119,42,161
"1029","Zona_6-Area_12-Sottoarea_25",2015,9,162,65,227
"1030","Zona_6-Area_12-Sottoarea_25",2015,10,180,74,254
"1031","Zona_6-Area_12-Sottoarea_25",2015,11,158,67,225
"1032","Zona_6-Area_12-Sottoarea_25",2015,12,142,53,195
"1033","Zona_6-Area_12-Sottoarea_25",2016,1,152,51,203
"1034","Zona_6-Area_12-Sottoarea_25",2016,2,165,70,235
"1035","Zona_6-Area_12-Sottoarea_25",2016,3,167,67,234
"1036","Zona_6-Area_12-Sottoarea_25",2016,4,152,69,221
"1037","Zona_6-Area_12-Sottoarea_25",2016,5,86,36,122
"1038","Zona_6-Area_12-Sottoarea_25",2016,6,0,0,0
"1039","Zona_6-Area_12-Sottoarea_25",2016,7,0,0,0
"1040","Zona_6-Area_12-Sottoarea_25",2016,8,0,0,0
"1041","Zona_6-Area_12-Sottoarea_25",2016,9,0,0,0
"1042","Zona_6-Area_12-Sottoarea_25",2016,10,0,0,0
"1043","Zona_6-Area_12-Sottoarea_25",2016,11,0,0,0
"1044","Zona_6-Area_12-Sottoarea_25",2016,12,0,0,0
"1045","Zona_6-Area_13-Sottoarea_50",2014,1,176,63,239
"1046","Zona_6-Area_13-Sottoarea_50",2014,2,167,79,246
"1047","Zona_6-Area_13-Sottoarea_50",2014,3,130,59,189
"1048","Zona_6-Area_13-Sottoarea_50",2014,4,164,61,225
"1049","Zona_6-Area_13-Sottoarea_50",2014,5,176,68,244
"1050","Zona_6-Area_13-Sottoarea_50",2014,6,152,57,209
"1051","Zona_6-Area_13-Sottoarea_50",2014,7,162,59,221
"1052","Zona_6-Area_13-Sottoarea_50",2014,8,114,52,166
"1053","Zona_6-Area_13-Sottoarea_50",2014,9,175,47,222
"1054","Zona_6-Area_13-Sottoarea_50",2014,10,221,79,300
"1055","Zona_6-Area_13-Sottoarea_50",2014,11,203,78,281
"1056","Zona_6-Area_13-Sottoarea_50",2014,12,165,76,241
"1057","Zona_6-Area_13-Sottoarea_50",2015,1,204,90,294
"1058","Zona_6-Area_13-Sottoarea_50",2015,2,202,100,302
"1059","Zona_6-Area_13-Sottoarea_50",2015,3,220,104,324
"1060","Zona_6-Area_13-Sottoarea_50",2015,4,200,154,354
"1061","Zona_6-Area_13-Sottoarea_50",2015,5,213,103,316
"1062","Zona_6-Area_13-Sottoarea_50",2015,6,213,119,332
"1063","Zona_6-Area_13-Sottoarea_50",2015,7,199,116,315
"1064","Zona_6-Area_13-Sottoarea_50",2015,8,157,80,237
"1065","Zona_6-Area_13-Sottoarea_50",2015,9,235,134,369
"1066","Zona_6-Area_13-Sottoarea_50",2015,10,256,116,372
"1067","Zona_6-Area_13-Sottoarea_50",2015,11,235,110,345
"1068","Zona_6-Area_13-Sottoarea_50",2015,12,210,93,303
"1069","Zona_6-Area_13-Sottoarea_50",2016,1,220,77,297
"1070","Zona_6-Area_13-Sottoarea_50",2016,2,253,113,366
"1071","Zona_6-Area_13-Sottoarea_50",2016,3,253,128,381
"1072","Zona_6-Area_13-Sottoarea_50",2016,4,239,90,329
"1073","Zona_6-Area_13-Sottoarea_50",2016,5,140,69,209
"1074","Zona_6-Area_13-Sottoarea_50",2016,6,0,0,0
"1075","Zona_6-Area_13-Sottoarea_50",2016,7,0,0,0
"1076","Zona_6-Area_13-Sottoarea_50",2016,8,0,0,0
"1077","Zona_6-Area_13-Sottoarea_50",2016,9,0,0,0
"1078","Zona_6-Area_13-Sottoarea_50",2016,10,0,0,0
"1079","Zona_6-Area_13-Sottoarea_50",2016,11,0,0,0
"1080","Zona_6-Area_13-Sottoarea_50",2016,12,0,0,0
"1081","Zona_6-Area_14-Sottoarea_106",2014,1,151,94,245
"1082","Zona_6-Area_14-Sottoarea_106",2014,2,160,127,287
"1083","Zona_6-Area_14-Sottoarea_106",2014,3,119,81,200
"1084","Zona_6-Area_14-Sottoarea_106",2014,4,165,73,238
"1085","Zona_6-Area_14-Sottoarea_106",2014,5,173,82,255
"1086","Zona_6-Area_14-Sottoarea_106",2014,6,154,64,218
"1087","Zona_6-Area_14-Sottoarea_106",2014,7,154,76,230
"1088","Zona_6-Area_14-Sottoarea_106",2014,8,106,55,161
"1089","Zona_6-Area_14-Sottoarea_106",2014,9,151,54,205
"1090","Zona_6-Area_14-Sottoarea_106",2014,10,182,80,262
"1091","Zona_6-Area_14-Sottoarea_106",2014,11,170,73,243
"1092","Zona_6-Area_14-Sottoarea_106",2014,12,139,82,221
"1093","Zona_6-Area_14-Sottoarea_106",2015,1,164,93,257
"1094","Zona_6-Area_14-Sottoarea_106",2015,2,177,127,304
"1095","Zona_6-Area_14-Sottoarea_106",2015,3,195,109,304
"1096","Zona_6-Area_14-Sottoarea_106",2015,4,171,109,280
"1097","Zona_6-Area_14-Sottoarea_106",2015,5,186,91,277
"1098","Zona_6-Area_14-Sottoarea_106",2015,6,198,89,287
"1099","Zona_6-Area_14-Sottoarea_106",2015,7,189,75,264
"1100","Zona_6-Area_14-Sottoarea_106",2015,8,131,59,190
"1101","Zona_6-Area_14-Sottoarea_106",2015,9,198,91,289
"1102","Zona_6-Area_14-Sottoarea_106",2015,10,219,94,313
"1103","Zona_6-Area_14-Sottoarea_106",2015,11,210,93,303
"1104","Zona_6-Area_14-Sottoarea_106",2015,12,192,84,276
"1105","Zona_6-Area_14-Sottoarea_106",2016,1,207,77,284
"1106","Zona_6-Area_14-Sottoarea_106",2016,2,216,118,334
"1107","Zona_6-Area_14-Sottoarea_106",2016,3,240,112,352
"1108","Zona_6-Area_14-Sottoarea_106",2016,4,223,108,331
"1109","Zona_6-Area_14-Sottoarea_106",2016,5,133,65,198
"1110","Zona_6-Area_14-Sottoarea_106",2016,6,0,0,0
"1111","Zona_6-Area_14-Sottoarea_106",2016,7,0,0,0
"1112","Zona_6-Area_14-Sottoarea_106",2016,8,0,0,0
"1113","Zona_6-Area_14-Sottoarea_106",2016,9,0,0,0
"1114","Zona_6-Area_14-Sottoarea_106",2016,10,0,0,0
"1115","Zona_6-Area_14-Sottoarea_106",2016,11,0,0,0
"1116","Zona_6-Area_14-Sottoarea_106",2016,12,0,0,0
"1117","Zona_6-Area_14-Sottoarea_107",2014,1,54,21,75
"1118","Zona_6-Area_14-Sottoarea_107",2014,2,55,23,78
"1119","Zona_6-Area_14-Sottoarea_107",2014,3,41,16,57
"1120","Zona_6-Area_14-Sottoarea_107",2014,4,58,18,76
"1121","Zona_6-Area_14-Sottoarea_107",2014,5,49,20,69
"1122","Zona_6-Area_14-Sottoarea_107",2014,6,55,18,73
"1123","Zona_6-Area_14-Sottoarea_107",2014,7,54,21,75
"1124","Zona_6-Area_14-Sottoarea_107",2014,8,39,15,54
"1125","Zona_6-Area_14-Sottoarea_107",2014,9,58,9,67
"1126","Zona_6-Area_14-Sottoarea_107",2014,10,72,29,101
"1127","Zona_6-Area_14-Sottoarea_107",2014,11,63,18,81
"1128","Zona_6-Area_14-Sottoarea_107",2014,12,50,21,71
"1129","Zona_6-Area_14-Sottoarea_107",2015,1,56,25,81
"1130","Zona_6-Area_14-Sottoarea_107",2015,2,64,23,87
"1131","Zona_6-Area_14-Sottoarea_107",2015,3,71,53,124
"1132","Zona_6-Area_14-Sottoarea_107",2015,4,59,42,101
"1133","Zona_6-Area_14-Sottoarea_107",2015,5,62,25,87
"1134","Zona_6-Area_14-Sottoarea_107",2015,6,57,19,76
"1135","Zona_6-Area_14-Sottoarea_107",2015,7,56,23,79
"1136","Zona_6-Area_14-Sottoarea_107",2015,8,41,16,57
"1137","Zona_6-Area_14-Sottoarea_107",2015,9,64,23,87
"1138","Zona_6-Area_14-Sottoarea_107",2015,10,68,31,99
"1139","Zona_6-Area_14-Sottoarea_107",2015,11,59,31,90
"1140","Zona_6-Area_14-Sottoarea_107",2015,12,53,21,74
"1141","Zona_6-Area_14-Sottoarea_107",2016,1,54,23,77
"1142","Zona_6-Area_14-Sottoarea_107",2016,2,74,32,106
"1143","Zona_6-Area_14-Sottoarea_107",2016,3,78,36,114
"1144","Zona_6-Area_14-Sottoarea_107",2016,4,65,81,146
"1145","Zona_6-Area_14-Sottoarea_107",2016,5,34,28,62
"1146","Zona_6-Area_14-Sottoarea_107",2016,6,0,0,0
"1147","Zona_6-Area_14-Sottoarea_107",2016,7,0,0,0
"1148","Zona_6-Area_14-Sottoarea_107",2016,8,0,0,0
"1149","Zona_6-Area_14-Sottoarea_107",2016,9,0,0,0
"1150","Zona_6-Area_14-Sottoarea_107",2016,10,0,0,0
"1151","Zona_6-Area_14-Sottoarea_107",2016,11,0,0,0
"1152","Zona_6-Area_14-Sottoarea_107",2016,12,0,0,0
"1153","Zona_7-Area_15-Sottoarea_21",2014,1,107,39,146
"1154","Zona_7-Area_15-Sottoarea_21",2014,2,120,53,173
"1155","Zona_7-Area_15-Sottoarea_21",2014,3,108,42,150
"1156","Zona_7-Area_15-Sottoarea_21",2014,4,113,52,165
"1157","Zona_7-Area_15-Sottoarea_21",2014,5,119,50,169
"1158","Zona_7-Area_15-Sottoarea_21",2014,6,98,46,144
"1159","Zona_7-Area_15-Sottoarea_21",2014,7,107,55,162
"1160","Zona_7-Area_15-Sottoarea_21",2014,8,72,47,119
"1161","Zona_7-Area_15-Sottoarea_21",2014,9,127,58,185
"1162","Zona_7-Area_15-Sottoarea_21",2014,10,132,86,218
"1163","Zona_7-Area_15-Sottoarea_21",2014,11,117,83,200
"1164","Zona_7-Area_15-Sottoarea_21",2014,12,93,64,157
"1165","Zona_7-Area_15-Sottoarea_21",2015,1,128,74,202
"1166","Zona_7-Area_15-Sottoarea_21",2015,2,116,92,208
"1167","Zona_7-Area_15-Sottoarea_21",2015,3,126,90,216
"1168","Zona_7-Area_15-Sottoarea_21",2015,4,112,78,190
"1169","Zona_7-Area_15-Sottoarea_21",2015,5,112,81,193
"1170","Zona_7-Area_15-Sottoarea_21",2015,6,114,76,190
"1171","Zona_7-Area_15-Sottoarea_21",2015,7,114,84,198
"1172","Zona_7-Area_15-Sottoarea_21",2015,8,90,54,144
"1173","Zona_7-Area_15-Sottoarea_21",2015,9,126,62,188
"1174","Zona_7-Area_15-Sottoarea_21",2015,10,132,85,217
"1175","Zona_7-Area_15-Sottoarea_21",2015,11,125,82,207
"1176","Zona_7-Area_15-Sottoarea_21",2015,12,115,73,188
"1177","Zona_7-Area_15-Sottoarea_21",2016,1,128,82,210
"1178","Zona_7-Area_15-Sottoarea_21",2016,2,148,97,245
"1179","Zona_7-Area_15-Sottoarea_21",2016,3,157,103,260
"1180","Zona_7-Area_15-Sottoarea_21",2016,4,137,61,198
"1181","Zona_7-Area_15-Sottoarea_21",2016,5,85,40,125
"1182","Zona_7-Area_15-Sottoarea_21",2016,6,0,0,0
"1183","Zona_7-Area_15-Sottoarea_21",2016,7,0,0,0
"1184","Zona_7-Area_15-Sottoarea_21",2016,8,0,0,0
"1185","Zona_7-Area_15-Sottoarea_21",2016,9,0,0,0
"1186","Zona_7-Area_15-Sottoarea_21",2016,10,0,0,0
"1187","Zona_7-Area_15-Sottoarea_21",2016,11,0,0,0
"1188","Zona_7-Area_15-Sottoarea_21",2016,12,0,0,0
"1189","Zona_7-Area_16-Sottoarea_100",2014,1,128,53,181
"1190","Zona_7-Area_16-Sottoarea_100",2014,2,118,55,173
"1191","Zona_7-Area_16-Sottoarea_100",2014,3,115,54,169
"1192","Zona_7-Area_16-Sottoarea_100",2014,4,122,56,178
"1193","Zona_7-Area_16-Sottoarea_100",2014,5,137,56,193
"1194","Zona_7-Area_16-Sottoarea_100",2014,6,131,53,184
"1195","Zona_7-Area_16-Sottoarea_100",2014,7,140,48,188
"1196","Zona_7-Area_16-Sottoarea_100",2014,8,105,48,153
"1197","Zona_7-Area_16-Sottoarea_100",2014,9,170,59,229
"1198","Zona_7-Area_16-Sottoarea_100",2014,10,196,67,263
"1199","Zona_7-Area_16-Sottoarea_100",2014,11,163,74,237
"1200","Zona_7-Area_16-Sottoarea_100",2014,12,123,80,203
"1201","Zona_7-Area_16-Sottoarea_100",2015,1,167,67,234
"1202","Zona_7-Area_16-Sottoarea_100",2015,2,165,91,256
"1203","Zona_7-Area_16-Sottoarea_100",2015,3,157,123,280
"1204","Zona_7-Area_16-Sottoarea_100",2015,4,126,88,214
"1205","Zona_7-Area_16-Sottoarea_100",2015,5,133,88,221
"1206","Zona_7-Area_16-Sottoarea_100",2015,6,151,90,241
"1207","Zona_7-Area_16-Sottoarea_100",2015,7,169,97,266
"1208","Zona_7-Area_16-Sottoarea_100",2015,8,117,59,176
"1209","Zona_7-Area_16-Sottoarea_100",2015,9,176,76,252
"1210","Zona_7-Area_16-Sottoarea_100",2015,10,178,99,277
"1211","Zona_7-Area_16-Sottoarea_100",2015,11,152,86,238
"1212","Zona_7-Area_16-Sottoarea_100",2015,12,148,78,226
"1213","Zona_7-Area_16-Sottoarea_100",2016,1,160,76,236
"1214","Zona_7-Area_16-Sottoarea_100",2016,2,169,115,284
"1215","Zona_7-Area_16-Sottoarea_100",2016,3,179,127,306
"1216","Zona_7-Area_16-Sottoarea_100",2016,4,147,97,244
"1217","Zona_7-Area_16-Sottoarea_100",2016,5,93,73,166
"1218","Zona_7-Area_16-Sottoarea_100",2016,6,0,0,0
"1219","Zona_7-Area_16-Sottoarea_100",2016,7,0,0,0
"1220","Zona_7-Area_16-Sottoarea_100",2016,8,0,0,0
"1221","Zona_7-Area_16-Sottoarea_100",2016,9,0,0,0
"1222","Zona_7-Area_16-Sottoarea_100",2016,10,0,0,0
"1223","Zona_7-Area_16-Sottoarea_100",2016,11,0,0,0
"1224","Zona_7-Area_16-Sottoarea_100",2016,12,0,0,0
"1225","Zona_7-Area_17-Sottoarea_139",2014,1,135,80,215
"1226","Zona_7-Area_17-Sottoarea_139",2014,2,150,82,232
"1227","Zona_7-Area_17-Sottoarea_139",2014,3,145,77,222
"1228","Zona_7-Area_17-Sottoarea_139",2014,4,156,77,233
"1229","Zona_7-Area_17-Sottoarea_139",2014,5,157,74,231
"1230","Zona_7-Area_17-Sottoarea_139",2014,6,144,65,209
"1231","Zona_7-Area_17-Sottoarea_139",2014,7,150,72,222
"1232","Zona_7-Area_17-Sottoarea_139",2014,8,132,61,193
"1233","Zona_7-Area_17-Sottoarea_139",2014,9,194,64,258
"1234","Zona_7-Area_17-Sottoarea_139",2014,10,247,90,337
"1235","Zona_7-Area_17-Sottoarea_139",2014,11,202,90,292
"1236","Zona_7-Area_17-Sottoarea_139",2014,12,146,88,234
"1237","Zona_7-Area_17-Sottoarea_139",2015,1,206,76,282
"1238","Zona_7-Area_17-Sottoarea_139",2015,2,185,104,289
"1239","Zona_7-Area_17-Sottoarea_139",2015,3,192,117,309
"1240","Zona_7-Area_17-Sottoarea_139",2015,4,170,98,268
"1241","Zona_7-Area_17-Sottoarea_139",2015,5,171,85,256
"1242","Zona_7-Area_17-Sottoarea_139",2015,6,170,89,259
"1243","Zona_7-Area_17-Sottoarea_139",2015,7,161,99,260
"1244","Zona_7-Area_17-Sottoarea_139",2015,8,126,66,192
"1245","Zona_7-Area_17-Sottoarea_139",2015,9,172,82,254
"1246","Zona_7-Area_17-Sottoarea_139",2015,10,207,98,305
"1247","Zona_7-Area_17-Sottoarea_139",2015,11,180,101,281
"1248","Zona_7-Area_17-Sottoarea_139",2015,12,167,95,262
"1249","Zona_7-Area_17-Sottoarea_139",2016,1,169,70,239
"1250","Zona_7-Area_17-Sottoarea_139",2016,2,179,95,274
"1251","Zona_7-Area_17-Sottoarea_139",2016,3,187,117,304
"1252","Zona_7-Area_17-Sottoarea_139",2016,4,166,83,249
"1253","Zona_7-Area_17-Sottoarea_139",2016,5,110,63,173
"1254","Zona_7-Area_17-Sottoarea_139",2016,6,0,0,0
"1255","Zona_7-Area_17-Sottoarea_139",2016,7,0,0,0
"1256","Zona_7-Area_17-Sottoarea_139",2016,8,0,0,0
"1257","Zona_7-Area_17-Sottoarea_139",2016,9,0,0,0
"1258","Zona_7-Area_17-Sottoarea_139",2016,10,0,0,0
"1259","Zona_7-Area_17-Sottoarea_139",2016,11,0,0,0
"1260","Zona_7-Area_17-Sottoarea_139",2016,12,0,0,0
"1261","Zona_7-Area_18-Sottoarea_137",2014,1,75,30,105
"1262","Zona_7-Area_18-Sottoarea_137",2014,2,83,36,119
"1263","Zona_7-Area_18-Sottoarea_137",2014,3,80,32,112
"1264","Zona_7-Area_18-Sottoarea_137",2014,4,85,38,123
"1265","Zona_7-Area_18-Sottoarea_137",2014,5,90,29,119
"1266","Zona_7-Area_18-Sottoarea_137",2014,6,70,33,103
"1267","Zona_7-Area_18-Sottoarea_137",2014,7,74,42,116
"1268","Zona_7-Area_18-Sottoarea_137",2014,8,58,37,95
"1269","Zona_7-Area_18-Sottoarea_137",2014,9,89,37,126
"1270","Zona_7-Area_18-Sottoarea_137",2014,10,99,41,140
"1271","Zona_7-Area_18-Sottoarea_137",2014,11,82,59,141
"1272","Zona_7-Area_18-Sottoarea_137",2014,12,69,49,118
"1273","Zona_7-Area_18-Sottoarea_137",2015,1,102,44,146
"1274","Zona_7-Area_18-Sottoarea_137",2015,2,90,75,165
"1275","Zona_7-Area_18-Sottoarea_137",2015,3,94,64,158
"1276","Zona_7-Area_18-Sottoarea_137",2015,4,83,57,140
"1277","Zona_7-Area_18-Sottoarea_137",2015,5,93,54,147
"1278","Zona_7-Area_18-Sottoarea_137",2015,6,85,48,133
"1279","Zona_7-Area_18-Sottoarea_137",2015,7,86,65,151
"1280","Zona_7-Area_18-Sottoarea_137",2015,8,70,39,109
"1281","Zona_7-Area_18-Sottoarea_137",2015,9,97,46,143
"1282","Zona_7-Area_18-Sottoarea_137",2015,10,116,56,172
"1283","Zona_7-Area_18-Sottoarea_137",2015,11,102,55,157
"1284","Zona_7-Area_18-Sottoarea_137",2015,12,91,51,142
"1285","Zona_7-Area_18-Sottoarea_137",2016,1,100,49,149
"1286","Zona_7-Area_18-Sottoarea_137",2016,2,115,65,180
"1287","Zona_7-Area_18-Sottoarea_137",2016,3,127,63,190
"1288","Zona_7-Area_18-Sottoarea_137",2016,4,119,45,164
"1289","Zona_7-Area_18-Sottoarea_137",2016,5,75,29,104
"1290","Zona_7-Area_18-Sottoarea_137",2016,6,0,0,0
"1291","Zona_7-Area_18-Sottoarea_137",2016,7,0,0,0
"1292","Zona_7-Area_18-Sottoarea_137",2016,8,0,0,0
"1293","Zona_7-Area_18-Sottoarea_137",2016,9,0,0,0
"1294","Zona_7-Area_18-Sottoarea_137",2016,10,0,0,0
"1295","Zona_7-Area_18-Sottoarea_137",2016,11,0,0,0
"1296","Zona_7-Area_18-Sottoarea_137",2016,12,0,0,0
"1297","Zona_7-Area_18-Sottoarea_138",2014,1,80,30,110
"1298","Zona_7-Area_18-Sottoarea_138",2014,2,77,31,108
"1299","Zona_7-Area_18-Sottoarea_138",2014,3,67,26,93
"1300","Zona_7-Area_18-Sottoarea_138",2014,4,73,24,97
"1301","Zona_7-Area_18-Sottoarea_138",2014,5,83,32,115
"1302","Zona_7-Area_18-Sottoarea_138",2014,6,69,28,97
"1303","Zona_7-Area_18-Sottoarea_138",2014,7,72,39,111
"1304","Zona_7-Area_18-Sottoarea_138",2014,8,53,28,81
"1305","Zona_7-Area_18-Sottoarea_138",2014,9,81,23,104
"1306","Zona_7-Area_18-Sottoarea_138",2014,10,117,39,156
"1307","Zona_7-Area_18-Sottoarea_138",2014,11,102,39,141
"1308","Zona_7-Area_18-Sottoarea_138",2014,12,88,46,134
"1309","Zona_7-Area_18-Sottoarea_138",2015,1,87,48,135
"1310","Zona_7-Area_18-Sottoarea_138",2015,2,96,70,166
"1311","Zona_7-Area_18-Sottoarea_138",2015,3,99,61,160
"1312","Zona_7-Area_18-Sottoarea_138",2015,4,81,54,135
"1313","Zona_7-Area_18-Sottoarea_138",2015,5,91,59,150
"1314","Zona_7-Area_18-Sottoarea_138",2015,6,85,51,136
"1315","Zona_7-Area_18-Sottoarea_138",2015,7,86,60,146
"1316","Zona_7-Area_18-Sottoarea_138",2015,8,69,34,103
"1317","Zona_7-Area_18-Sottoarea_138",2015,9,97,43,140
"1318","Zona_7-Area_18-Sottoarea_138",2015,10,96,55,151
"1319","Zona_7-Area_18-Sottoarea_138",2015,11,87,61,148
"1320","Zona_7-Area_18-Sottoarea_138",2015,12,77,41,118
"1321","Zona_7-Area_18-Sottoarea_138",2016,1,90,43,133
"1322","Zona_7-Area_18-Sottoarea_138",2016,2,96,56,152
"1323","Zona_7-Area_18-Sottoarea_138",2016,3,95,57,152
"1324","Zona_7-Area_18-Sottoarea_138",2016,4,89,41,130
"1325","Zona_7-Area_18-Sottoarea_138",2016,5,56,26,82
"1326","Zona_7-Area_18-Sottoarea_138",2016,6,0,0,0
"1327","Zona_7-Area_18-Sottoarea_138",2016,7,0,0,0
"1328","Zona_7-Area_18-Sottoarea_138",2016,8,0,0,0
"1329","Zona_7-Area_18-Sottoarea_138",2016,9,0,0,0
"1330","Zona_7-Area_18-Sottoarea_138",2016,10,0,0,0
"1331","Zona_7-Area_18-Sottoarea_138",2016,11,0,0,0
"1332","Zona_7-Area_18-Sottoarea_138",2016,12,0,0,0
"1333","Zona_8-Area_19-Sottoarea_54",2014,1,80,41,121
"1334","Zona_8-Area_19-Sottoarea_54",2014,2,85,39,124
"1335","Zona_8-Area_19-Sottoarea_54",2014,3,73,39,112
"1336","Zona_8-Area_19-Sottoarea_54",2014,4,84,42,126
"1337","Zona_8-Area_19-Sottoarea_54",2014,5,94,43,137
"1338","Zona_8-Area_19-Sottoarea_54",2014,6,73,50,123
"1339","Zona_8-Area_19-Sottoarea_54",2014,7,77,60,137
"1340","Zona_8-Area_19-Sottoarea_54",2014,8,51,50,101
"1341","Zona_8-Area_19-Sottoarea_54",2014,9,89,40,129
"1342","Zona_8-Area_19-Sottoarea_54",2014,10,106,57,163
"1343","Zona_8-Area_19-Sottoarea_54",2014,11,90,39,129
"1344","Zona_8-Area_19-Sottoarea_54",2014,12,80,50,130
"1345","Zona_8-Area_19-Sottoarea_54",2015,1,98,67,165
"1346","Zona_8-Area_19-Sottoarea_54",2015,2,99,115,214
"1347","Zona_8-Area_19-Sottoarea_54",2015,3,98,102,200
"1348","Zona_8-Area_19-Sottoarea_54",2015,4,89,87,176
"1349","Zona_8-Area_19-Sottoarea_54",2015,5,106,59,165
"1350","Zona_8-Area_19-Sottoarea_54",2015,6,111,55,166
"1351","Zona_8-Area_19-Sottoarea_54",2015,7,110,59,169
"1352","Zona_8-Area_19-Sottoarea_54",2015,8,67,38,105
"1353","Zona_8-Area_19-Sottoarea_54",2015,9,114,49,163
"1354","Zona_8-Area_19-Sottoarea_54",2015,10,125,51,176
"1355","Zona_8-Area_19-Sottoarea_54",2015,11,101,48,149
"1356","Zona_8-Area_19-Sottoarea_54",2015,12,103,48,151
"1357","Zona_8-Area_19-Sottoarea_54",2016,1,105,31,136
"1358","Zona_8-Area_19-Sottoarea_54",2016,2,116,53,169
"1359","Zona_8-Area_19-Sottoarea_54",2016,3,128,65,193
"1360","Zona_8-Area_19-Sottoarea_54",2016,4,104,43,147
"1361","Zona_8-Area_19-Sottoarea_54",2016,5,60,28,88
"1362","Zona_8-Area_19-Sottoarea_54",2016,6,0,0,0
"1363","Zona_8-Area_19-Sottoarea_54",2016,7,0,0,0
"1364","Zona_8-Area_19-Sottoarea_54",2016,8,0,0,0
"1365","Zona_8-Area_19-Sottoarea_54",2016,9,0,0,0
"1366","Zona_8-Area_19-Sottoarea_54",2016,10,0,0,0
"1367","Zona_8-Area_19-Sottoarea_54",2016,11,0,0,0
"1368","Zona_8-Area_19-Sottoarea_54",2016,12,0,0,0
"1369","Zona_8-Area_19-Sottoarea_55",2014,1,148,65,213
"1370","Zona_8-Area_19-Sottoarea_55",2014,2,152,67,219
"1371","Zona_8-Area_19-Sottoarea_55",2014,3,112,58,170
"1372","Zona_8-Area_19-Sottoarea_55",2014,4,125,69,194
"1373","Zona_8-Area_19-Sottoarea_55",2014,5,136,64,200
"1374","Zona_8-Area_19-Sottoarea_55",2014,6,114,59,173
"1375","Zona_8-Area_19-Sottoarea_55",2014,7,125,61,186
"1376","Zona_8-Area_19-Sottoarea_55",2014,8,99,51,150
"1377","Zona_8-Area_19-Sottoarea_55",2014,9,124,50,174
"1378","Zona_8-Area_19-Sottoarea_55",2014,10,142,78,220
"1379","Zona_8-Area_19-Sottoarea_55",2014,11,125,64,189
"1380","Zona_8-Area_19-Sottoarea_55",2014,12,121,64,185
"1381","Zona_8-Area_19-Sottoarea_55",2015,1,129,60,189
"1382","Zona_8-Area_19-Sottoarea_55",2015,2,141,90,231
"1383","Zona_8-Area_19-Sottoarea_55",2015,3,146,109,255
"1384","Zona_8-Area_19-Sottoarea_55",2015,4,130,71,201
"1385","Zona_8-Area_19-Sottoarea_55",2015,5,116,102,218
"1386","Zona_8-Area_19-Sottoarea_55",2015,6,144,109,253
"1387","Zona_8-Area_19-Sottoarea_55",2015,7,152,66,218
"1388","Zona_8-Area_19-Sottoarea_55",2015,8,103,46,149
"1389","Zona_8-Area_19-Sottoarea_55",2015,9,156,61,217
"1390","Zona_8-Area_19-Sottoarea_55",2015,10,187,80,267
"1391","Zona_8-Area_19-Sottoarea_55",2015,11,171,75,246
"1392","Zona_8-Area_19-Sottoarea_55",2015,12,166,65,231
"1393","Zona_8-Area_19-Sottoarea_55",2016,1,178,64,242
"1394","Zona_8-Area_19-Sottoarea_55",2016,2,179,61,240
"1395","Zona_8-Area_19-Sottoarea_55",2016,3,186,74,260
"1396","Zona_8-Area_19-Sottoarea_55",2016,4,165,67,232
"1397","Zona_8-Area_19-Sottoarea_55",2016,5,95,37,132
"1398","Zona_8-Area_19-Sottoarea_55",2016,6,0,0,0
"1399","Zona_8-Area_19-Sottoarea_55",2016,7,0,0,0
"1400","Zona_8-Area_19-Sottoarea_55",2016,8,0,0,0
"1401","Zona_8-Area_19-Sottoarea_55",2016,9,0,0,0
"1402","Zona_8-Area_19-Sottoarea_55",2016,10,0,0,0
"1403","Zona_8-Area_19-Sottoarea_55",2016,11,0,0,0
"1404","Zona_8-Area_19-Sottoarea_55",2016,12,0,0,0
"1405","Zona_8-Area_20-Sottoarea_56",2014,1,11,3,14
"1406","Zona_8-Area_20-Sottoarea_56",2014,2,14,4,18
"1407","Zona_8-Area_20-Sottoarea_56",2014,3,15,2,17
"1408","Zona_8-Area_20-Sottoarea_56",2014,4,9,0,9
"1409","Zona_8-Area_20-Sottoarea_56",2014,5,15,1,16
"1410","Zona_8-Area_20-Sottoarea_56",2014,6,7,2,9
"1411","Zona_8-Area_20-Sottoarea_56",2014,7,11,1,12
"1412","Zona_8-Area_20-Sottoarea_56",2014,8,3,0,3
"1413","Zona_8-Area_20-Sottoarea_56",2014,9,13,2,15
"1414","Zona_8-Area_20-Sottoarea_56",2014,10,10,3,13
"1415","Zona_8-Area_20-Sottoarea_56",2014,11,11,2,13
"1416","Zona_8-Area_20-Sottoarea_56",2014,12,11,0,11
"1417","Zona_8-Area_20-Sottoarea_56",2015,1,15,0,15
"1418","Zona_8-Area_20-Sottoarea_56",2015,2,18,7,25
"1419","Zona_8-Area_20-Sottoarea_56",2015,3,16,4,20
"1420","Zona_8-Area_20-Sottoarea_56",2015,4,10,2,12
"1421","Zona_8-Area_20-Sottoarea_56",2015,5,8,13,21
"1422","Zona_8-Area_20-Sottoarea_56",2015,6,12,9,21
"1423","Zona_8-Area_20-Sottoarea_56",2015,7,10,3,13
"1424","Zona_8-Area_20-Sottoarea_56",2015,8,5,3,8
"1425","Zona_8-Area_20-Sottoarea_56",2015,9,8,2,10
"1426","Zona_8-Area_20-Sottoarea_56",2015,10,17,4,21
"1427","Zona_8-Area_20-Sottoarea_56",2015,11,5,4,9
"1428","Zona_8-Area_20-Sottoarea_56",2015,12,11,2,13
"1429","Zona_8-Area_20-Sottoarea_56",2016,1,11,0,11
"1430","Zona_8-Area_20-Sottoarea_56",2016,2,12,3,15
"1431","Zona_8-Area_20-Sottoarea_56",2016,3,10,1,11
"1432","Zona_8-Area_20-Sottoarea_56",2016,4,5,0,5
"1433","Zona_8-Area_20-Sottoarea_56",2016,5,7,1,8
"1434","Zona_8-Area_20-Sottoarea_56",2016,6,0,0,0
"1435","Zona_8-Area_20-Sottoarea_56",2016,7,0,0,0
"1436","Zona_8-Area_20-Sottoarea_56",2016,8,0,0,0
"1437","Zona_8-Area_20-Sottoarea_56",2016,9,0,0,0
"1438","Zona_8-Area_20-Sottoarea_56",2016,10,0,0,0
"1439","Zona_8-Area_20-Sottoarea_56",2016,11,0,0,0
"1440","Zona_8-Area_20-Sottoarea_56",2016,12,0,0,0
"1441","Zona_8-Area_20-Sottoarea_57",2014,1,201,120,321
"1442","Zona_8-Area_20-Sottoarea_57",2014,2,228,133,361
"1443","Zona_8-Area_20-Sottoarea_57",2014,3,185,100,285
"1444","Zona_8-Area_20-Sottoarea_57",2014,4,204,106,310
"1445","Zona_8-Area_20-Sottoarea_57",2014,5,202,109,311
"1446","Zona_8-Area_20-Sottoarea_57",2014,6,181,91,272
"1447","Zona_8-Area_20-Sottoarea_57",2014,7,202,99,301
"1448","Zona_8-Area_20-Sottoarea_57",2014,8,150,83,233
"1449","Zona_8-Area_20-Sottoarea_57",2014,9,190,83,273
"1450","Zona_8-Area_20-Sottoarea_57",2014,10,237,114,351
"1451","Zona_8-Area_20-Sottoarea_57",2014,11,197,96,293
"1452","Zona_8-Area_20-Sottoarea_57",2014,12,198,104,302
"1453","Zona_8-Area_20-Sottoarea_57",2015,1,182,81,263
"1454","Zona_8-Area_20-Sottoarea_57",2015,2,220,166,386
"1455","Zona_8-Area_20-Sottoarea_57",2015,3,221,152,373
"1456","Zona_8-Area_20-Sottoarea_57",2015,4,211,129,340
"1457","Zona_8-Area_20-Sottoarea_57",2015,5,201,171,372
"1458","Zona_8-Area_20-Sottoarea_57",2015,6,212,133,345
"1459","Zona_8-Area_20-Sottoarea_57",2015,7,226,141,367
"1460","Zona_8-Area_20-Sottoarea_57",2015,8,168,91,259
"1461","Zona_8-Area_20-Sottoarea_57",2015,9,237,130,367
"1462","Zona_8-Area_20-Sottoarea_57",2015,10,268,140,408
"1463","Zona_8-Area_20-Sottoarea_57",2015,11,235,135,370
"1464","Zona_8-Area_20-Sottoarea_57",2015,12,231,108,339
"1465","Zona_8-Area_20-Sottoarea_57",2016,1,231,118,349
"1466","Zona_8-Area_20-Sottoarea_57",2016,2,245,138,383
"1467","Zona_8-Area_20-Sottoarea_57",2016,3,272,152,424
"1468","Zona_8-Area_20-Sottoarea_57",2016,4,241,132,373
"1469","Zona_8-Area_20-Sottoarea_57",2016,5,139,79,218
"1470","Zona_8-Area_20-Sottoarea_57",2016,6,0,0,0
"1471","Zona_8-Area_20-Sottoarea_57",2016,7,0,0,0
"1472","Zona_8-Area_20-Sottoarea_57",2016,8,0,0,0
"1473","Zona_8-Area_20-Sottoarea_57",2016,9,0,0,0
"1474","Zona_8-Area_20-Sottoarea_57",2016,10,0,0,0
"1475","Zona_8-Area_20-Sottoarea_57",2016,11,0,0,0
"1476","Zona_8-Area_20-Sottoarea_57",2016,12,0,0,0
"1477","Zona_8-Area_21-Sottoarea_58",2014,1,151,81,232
"1478","Zona_8-Area_21-Sottoarea_58",2014,2,152,80,232
"1479","Zona_8-Area_21-Sottoarea_58",2014,3,145,64,209
"1480","Zona_8-Area_21-Sottoarea_58",2014,4,177,80,257
"1481","Zona_8-Area_21-Sottoarea_58",2014,5,152,79,231
"1482","Zona_8-Area_21-Sottoarea_58",2014,6,141,64,205
"1483","Zona_8-Area_21-Sottoarea_58",2014,7,173,64,237
"1484","Zona_8-Area_21-Sottoarea_58",2014,8,142,51,193
"1485","Zona_8-Area_21-Sottoarea_58",2014,9,156,59,215
"1486","Zona_8-Area_21-Sottoarea_58",2014,10,215,94,309
"1487","Zona_8-Area_21-Sottoarea_58",2014,11,187,80,267
"1488","Zona_8-Area_21-Sottoarea_58",2014,12,147,85,232
"1489","Zona_8-Area_21-Sottoarea_58",2015,1,163,61,224
"1490","Zona_8-Area_21-Sottoarea_58",2015,2,178,127,305
"1491","Zona_8-Area_21-Sottoarea_58",2015,3,187,152,339
"1492","Zona_8-Area_21-Sottoarea_58",2015,4,164,116,280
"1493","Zona_8-Area_21-Sottoarea_58",2015,5,156,133,289
"1494","Zona_8-Area_21-Sottoarea_58",2015,6,161,152,313
"1495","Zona_8-Area_21-Sottoarea_58",2015,7,165,107,272
"1496","Zona_8-Area_21-Sottoarea_58",2015,8,132,77,209
"1497","Zona_8-Area_21-Sottoarea_58",2015,9,159,88,247
"1498","Zona_8-Area_21-Sottoarea_58",2015,10,191,127,318
"1499","Zona_8-Area_21-Sottoarea_58",2015,11,168,116,284
"1500","Zona_8-Area_21-Sottoarea_58",2015,12,165,83,248
"1501","Zona_8-Area_21-Sottoarea_58",2016,1,170,89,259
"1502","Zona_8-Area_21-Sottoarea_58",2016,2,194,115,309
"1503","Zona_8-Area_21-Sottoarea_58",2016,3,218,118,336
"1504","Zona_8-Area_21-Sottoarea_58",2016,4,190,97,287
"1505","Zona_8-Area_21-Sottoarea_58",2016,5,111,58,169
"1506","Zona_8-Area_21-Sottoarea_58",2016,6,0,0,0
"1507","Zona_8-Area_21-Sottoarea_58",2016,7,0,0,0
"1508","Zona_8-Area_21-Sottoarea_58",2016,8,0,0,0
"1509","Zona_8-Area_21-Sottoarea_58",2016,9,0,0,0
"1510","Zona_8-Area_21-Sottoarea_58",2016,10,0,0,0
"1511","Zona_8-Area_21-Sottoarea_58",2016,11,0,0,0
"1512","Zona_8-Area_21-Sottoarea_58",2016,12,0,0,0
"1513","Zona_8-Area_21-Sottoarea_59",2014,1,41,22,63
"1514","Zona_8-Area_21-Sottoarea_59",2014,2,40,16,56
"1515","Zona_8-Area_21-Sottoarea_59",2014,3,37,19,56
"1516","Zona_8-Area_21-Sottoarea_59",2014,4,48,20,68
"1517","Zona_8-Area_21-Sottoarea_59",2014,5,42,18,60
"1518","Zona_8-Area_21-Sottoarea_59",2014,6,39,16,55
"1519","Zona_8-Area_21-Sottoarea_59",2014,7,53,19,72
"1520","Zona_8-Area_21-Sottoarea_59",2014,8,48,11,59
"1521","Zona_8-Area_21-Sottoarea_59",2014,9,45,13,58
"1522","Zona_8-Area_21-Sottoarea_59",2014,10,68,17,85
"1523","Zona_8-Area_21-Sottoarea_59",2014,11,61,19,80
"1524","Zona_8-Area_21-Sottoarea_59",2014,12,53,20,73
"1525","Zona_8-Area_21-Sottoarea_59",2015,1,47,13,60
"1526","Zona_8-Area_21-Sottoarea_59",2015,2,54,29,83
"1527","Zona_8-Area_21-Sottoarea_59",2015,3,54,32,86
"1528","Zona_8-Area_21-Sottoarea_59",2015,4,62,27,89
"1529","Zona_8-Area_21-Sottoarea_59",2015,5,65,28,93
"1530","Zona_8-Area_21-Sottoarea_59",2015,6,63,39,102
"1531","Zona_8-Area_21-Sottoarea_59",2015,7,58,31,89
"1532","Zona_8-Area_21-Sottoarea_59",2015,8,46,24,70
"1533","Zona_8-Area_21-Sottoarea_59",2015,9,59,49,108
"1534","Zona_8-Area_21-Sottoarea_59",2015,10,66,73,139
"1535","Zona_8-Area_21-Sottoarea_59",2015,11,57,44,101
"1536","Zona_8-Area_21-Sottoarea_59",2015,12,54,54,108
"1537","Zona_8-Area_21-Sottoarea_59",2016,1,56,35,91
"1538","Zona_8-Area_21-Sottoarea_59",2016,2,65,36,101
"1539","Zona_8-Area_21-Sottoarea_59",2016,3,72,38,110
"1540","Zona_8-Area_21-Sottoarea_59",2016,4,58,29,87
"1541","Zona_8-Area_21-Sottoarea_59",2016,5,37,16,53
"1542","Zona_8-Area_21-Sottoarea_59",2016,6,0,0,0
"1543","Zona_8-Area_21-Sottoarea_59",2016,7,0,0,0
"1544","Zona_8-Area_21-Sottoarea_59",2016,8,0,0,0
"1545","Zona_8-Area_21-Sottoarea_59",2016,9,0,0,0
"1546","Zona_8-Area_21-Sottoarea_59",2016,10,0,0,0
"1547","Zona_8-Area_21-Sottoarea_59",2016,11,0,0,0
"1548","Zona_8-Area_21-Sottoarea_59",2016,12,0,0,0
"1549","Zona_8-Area_22-Sottoarea_60",2014,1,283,137,420
"1550","Zona_8-Area_22-Sottoarea_60",2014,2,289,134,423
"1551","Zona_8-Area_22-Sottoarea_60",2014,3,217,119,336
"1552","Zona_8-Area_22-Sottoarea_60",2014,4,254,133,387
"1553","Zona_8-Area_22-Sottoarea_60",2014,5,255,124,379
"1554","Zona_8-Area_22-Sottoarea_60",2014,6,213,109,322
"1555","Zona_8-Area_22-Sottoarea_60",2014,7,263,124,387
"1556","Zona_8-Area_22-Sottoarea_60",2014,8,188,95,283
"1557","Zona_8-Area_22-Sottoarea_60",2014,9,236,107,343
"1558","Zona_8-Area_22-Sottoarea_60",2014,10,267,147,414
"1559","Zona_8-Area_22-Sottoarea_60",2014,11,233,123,356
"1560","Zona_8-Area_22-Sottoarea_60",2014,12,227,117,344
"1561","Zona_8-Area_22-Sottoarea_60",2015,1,251,107,358
"1562","Zona_8-Area_22-Sottoarea_60",2015,2,276,249,525
"1563","Zona_8-Area_22-Sottoarea_60",2015,3,302,186,488
"1564","Zona_8-Area_22-Sottoarea_60",2015,4,244,172,416
"1565","Zona_8-Area_22-Sottoarea_60",2015,5,231,200,431
"1566","Zona_8-Area_22-Sottoarea_60",2015,6,237,165,402
"1567","Zona_8-Area_22-Sottoarea_60",2015,7,244,152,396
"1568","Zona_8-Area_22-Sottoarea_60",2015,8,195,127,322
"1569","Zona_8-Area_22-Sottoarea_60",2015,9,254,132,386
"1570","Zona_8-Area_22-Sottoarea_60",2015,10,287,162,449
"1571","Zona_8-Area_22-Sottoarea_60",2015,11,271,133,404
"1572","Zona_8-Area_22-Sottoarea_60",2015,12,263,123,386
"1573","Zona_8-Area_22-Sottoarea_60",2016,1,287,123,410
"1574","Zona_8-Area_22-Sottoarea_60",2016,2,321,153,474
"1575","Zona_8-Area_22-Sottoarea_60",2016,3,381,171,552
"1576","Zona_8-Area_22-Sottoarea_60",2016,4,355,160,515
"1577","Zona_8-Area_22-Sottoarea_60",2016,5,202,99,301
"1578","Zona_8-Area_22-Sottoarea_60",2016,6,0,0,0
"1579","Zona_8-Area_22-Sottoarea_60",2016,7,0,0,0
"1580","Zona_8-Area_22-Sottoarea_60",2016,8,0,0,0
"1581","Zona_8-Area_22-Sottoarea_60",2016,9,0,0,0
"1582","Zona_8-Area_22-Sottoarea_60",2016,10,0,0,0
"1583","Zona_8-Area_22-Sottoarea_60",2016,11,0,0,0
"1584","Zona_8-Area_22-Sottoarea_60",2016,12,0,0,0
"1585","Zona_9-Area_27-Sottoarea_61",2014,1,239,121,360
"1586","Zona_9-Area_27-Sottoarea_61",2014,2,264,122,386
"1587","Zona_9-Area_27-Sottoarea_61",2014,3,198,131,329
"1588","Zona_9-Area_27-Sottoarea_61",2014,4,248,138,386
"1589","Zona_9-Area_27-Sottoarea_61",2014,5,310,142,452
"1590","Zona_9-Area_27-Sottoarea_61",2014,6,249,117,366
"1591","Zona_9-Area_27-Sottoarea_61",2014,7,282,133,415
"1592","Zona_9-Area_27-Sottoarea_61",2014,8,212,140,352
"1593","Zona_9-Area_27-Sottoarea_61",2014,9,262,126,388
"1594","Zona_9-Area_27-Sottoarea_61",2014,10,270,138,408
"1595","Zona_9-Area_27-Sottoarea_61",2014,11,253,161,414
"1596","Zona_9-Area_27-Sottoarea_61",2014,12,288,174,462
"1597","Zona_9-Area_27-Sottoarea_61",2015,1,276,122,398
"1598","Zona_9-Area_27-Sottoarea_61",2015,2,283,165,448
"1599","Zona_9-Area_27-Sottoarea_61",2015,3,297,162,459
"1600","Zona_9-Area_27-Sottoarea_61",2015,4,281,206,487
"1601","Zona_9-Area_27-Sottoarea_61",2015,5,286,221,507
"1602","Zona_9-Area_27-Sottoarea_61",2015,6,255,121,376
"1603","Zona_9-Area_27-Sottoarea_61",2015,7,293,119,412
"1604","Zona_9-Area_27-Sottoarea_61",2015,8,196,94,290
"1605","Zona_9-Area_27-Sottoarea_61",2015,9,273,113,386
"1606","Zona_9-Area_27-Sottoarea_61",2015,10,328,134,462
"1607","Zona_9-Area_27-Sottoarea_61",2015,11,275,121,396
"1608","Zona_9-Area_27-Sottoarea_61",2015,12,259,108,367
"1609","Zona_9-Area_27-Sottoarea_61",2016,1,271,98,369
"1610","Zona_9-Area_27-Sottoarea_61",2016,2,296,135,431
"1611","Zona_9-Area_27-Sottoarea_61",2016,3,333,136,469
"1612","Zona_9-Area_27-Sottoarea_61",2016,4,294,146,440
"1613","Zona_9-Area_27-Sottoarea_61",2016,5,173,74,247
"1614","Zona_9-Area_27-Sottoarea_61",2016,6,0,0,0
"1615","Zona_9-Area_27-Sottoarea_61",2016,7,0,0,0
"1616","Zona_9-Area_27-Sottoarea_61",2016,8,0,0,0
"1617","Zona_9-Area_27-Sottoarea_61",2016,9,0,0,0
"1618","Zona_9-Area_27-Sottoarea_61",2016,10,0,0,0
"1619","Zona_9-Area_27-Sottoarea_61",2016,11,0,0,0
"1620","Zona_9-Area_27-Sottoarea_61",2016,12,0,0,0
"1621","Zona_9-Area_28-Sottoarea_62",2014,1,164,77,241
"1622","Zona_9-Area_28-Sottoarea_62",2014,2,178,73,251
"1623","Zona_9-Area_28-Sottoarea_62",2014,3,144,75,219
"1624","Zona_9-Area_28-Sottoarea_62",2014,4,167,80,247
"1625","Zona_9-Area_28-Sottoarea_62",2014,5,169,77,246
"1626","Zona_9-Area_28-Sottoarea_62",2014,6,163,77,240
"1627","Zona_9-Area_28-Sottoarea_62",2014,7,177,71,248
"1628","Zona_9-Area_28-Sottoarea_62",2014,8,119,75,194
"1629","Zona_9-Area_28-Sottoarea_62",2014,9,154,71,225
"1630","Zona_9-Area_28-Sottoarea_62",2014,10,170,77,247
"1631","Zona_9-Area_28-Sottoarea_62",2014,11,139,82,221
"1632","Zona_9-Area_28-Sottoarea_62",2014,12,133,92,225
"1633","Zona_9-Area_28-Sottoarea_62",2015,1,182,83,265
"1634","Zona_9-Area_28-Sottoarea_62",2015,2,180,85,265
"1635","Zona_9-Area_28-Sottoarea_62",2015,3,181,94,275
"1636","Zona_9-Area_28-Sottoarea_62",2015,4,168,124,292
"1637","Zona_9-Area_28-Sottoarea_62",2015,5,157,117,274
"1638","Zona_9-Area_28-Sottoarea_62",2015,6,147,75,222
"1639","Zona_9-Area_28-Sottoarea_62",2015,7,176,78,254
"1640","Zona_9-Area_28-Sottoarea_62",2015,8,120,64,184
"1641","Zona_9-Area_28-Sottoarea_62",2015,9,159,80,239
"1642","Zona_9-Area_28-Sottoarea_62",2015,10,183,96,279
"1643","Zona_9-Area_28-Sottoarea_62",2015,11,157,93,250
"1644","Zona_9-Area_28-Sottoarea_62",2015,12,159,101,260
"1645","Zona_9-Area_28-Sottoarea_62",2016,1,188,73,261
"1646","Zona_9-Area_28-Sottoarea_62",2016,2,186,97,283
"1647","Zona_9-Area_28-Sottoarea_62",2016,3,194,92,286
"1648","Zona_9-Area_28-Sottoarea_62",2016,4,177,83,260
"1649","Zona_9-Area_28-Sottoarea_62",2016,5,118,49,167
"1650","Zona_9-Area_28-Sottoarea_62",2016,6,0,0,0
"1651","Zona_9-Area_28-Sottoarea_62",2016,7,0,0,0
"1652","Zona_9-Area_28-Sottoarea_62",2016,8,0,0,0
"1653","Zona_9-Area_28-Sottoarea_62",2016,9,0,0,0
"1654","Zona_9-Area_28-Sottoarea_62",2016,10,0,0,0
"1655","Zona_9-Area_28-Sottoarea_62",2016,11,0,0,0
"1656","Zona_9-Area_28-Sottoarea_62",2016,12,0,0,0
"1657","Zona_9-Area_28-Sottoarea_63",2014,1,55,40,95
"1658","Zona_9-Area_28-Sottoarea_63",2014,2,71,41,112
"1659","Zona_9-Area_28-Sottoarea_63",2014,3,57,48,105
"1660","Zona_9-Area_28-Sottoarea_63",2014,4,70,42,112
"1661","Zona_9-Area_28-Sottoarea_63",2014,5,72,42,114
"1662","Zona_9-Area_28-Sottoarea_63",2014,6,72,50,122
"1663","Zona_9-Area_28-Sottoarea_63",2014,7,82,37,119
"1664","Zona_9-Area_28-Sottoarea_63",2014,8,64,48,112
"1665","Zona_9-Area_28-Sottoarea_63",2014,9,70,35,105
"1666","Zona_9-Area_28-Sottoarea_63",2014,10,71,40,111
"1667","Zona_9-Area_28-Sottoarea_63",2014,11,71,39,110
"1668","Zona_9-Area_28-Sottoarea_63",2014,12,82,37,119
"1669","Zona_9-Area_28-Sottoarea_63",2015,1,77,39,116
"1670","Zona_9-Area_28-Sottoarea_63",2015,2,78,38,116
"1671","Zona_9-Area_28-Sottoarea_63",2015,3,83,44,127
"1672","Zona_9-Area_28-Sottoarea_63",2015,4,78,54,132
"1673","Zona_9-Area_28-Sottoarea_63",2015,5,78,33,111
"1674","Zona_9-Area_28-Sottoarea_63",2015,6,69,36,105
"1675","Zona_9-Area_28-Sottoarea_63",2015,7,75,33,108
"1676","Zona_9-Area_28-Sottoarea_63",2015,8,52,23,75
"1677","Zona_9-Area_28-Sottoarea_63",2015,9,74,35,109
"1678","Zona_9-Area_28-Sottoarea_63",2015,10,83,31,114
"1679","Zona_9-Area_28-Sottoarea_63",2015,11,71,29,100
"1680","Zona_9-Area_28-Sottoarea_63",2015,12,65,31,96
"1681","Zona_9-Area_28-Sottoarea_63",2016,1,69,24,93
"1682","Zona_9-Area_28-Sottoarea_63",2016,2,77,32,109
"1683","Zona_9-Area_28-Sottoarea_63",2016,3,81,40,121
"1684","Zona_9-Area_28-Sottoarea_63",2016,4,71,60,131
"1685","Zona_9-Area_28-Sottoarea_63",2016,5,47,35,82
"1686","Zona_9-Area_28-Sottoarea_63",2016,6,0,0,0
"1687","Zona_9-Area_28-Sottoarea_63",2016,7,0,0,0
"1688","Zona_9-Area_28-Sottoarea_63",2016,8,0,0,0
"1689","Zona_9-Area_28-Sottoarea_63",2016,9,0,0,0
"1690","Zona_9-Area_28-Sottoarea_63",2016,10,0,0,0
"1691","Zona_9-Area_28-Sottoarea_63",2016,11,0,0,0
"1692","Zona_9-Area_28-Sottoarea_63",2016,12,0,0,0
"1693","Zona_10-Area_23-Sottoarea_22",2014,1,108,42,150
"1694","Zona_10-Area_23-Sottoarea_22",2014,2,126,58,184
"1695","Zona_10-Area_23-Sottoarea_22",2014,3,88,52,140
"1696","Zona_10-Area_23-Sottoarea_22",2014,4,112,55,167
"1697","Zona_10-Area_23-Sottoarea_22",2014,5,124,53,177
"1698","Zona_10-Area_23-Sottoarea_22",2014,6,100,49,149
"1699","Zona_10-Area_23-Sottoarea_22",2014,7,111,55,166
"1700","Zona_10-Area_23-Sottoarea_22",2014,8,77,40,117
"1701","Zona_10-Area_23-Sottoarea_22",2014,9,114,51,165
"1702","Zona_10-Area_23-Sottoarea_22",2014,10,135,71,206
"1703","Zona_10-Area_23-Sottoarea_22",2014,11,118,54,172
"1704","Zona_10-Area_23-Sottoarea_22",2014,12,127,58,185
"1705","Zona_10-Area_23-Sottoarea_22",2015,1,113,67,180
"1706","Zona_10-Area_23-Sottoarea_22",2015,2,113,57,170
"1707","Zona_10-Area_23-Sottoarea_22",2015,3,115,64,179
"1708","Zona_10-Area_23-Sottoarea_22",2015,4,112,80,192
"1709","Zona_10-Area_23-Sottoarea_22",2015,5,97,72,169
"1710","Zona_10-Area_23-Sottoarea_22",2015,6,112,50,162
"1711","Zona_10-Area_23-Sottoarea_22",2015,7,100,48,148
"1712","Zona_10-Area_23-Sottoarea_22",2015,8,77,35,112
"1713","Zona_10-Area_23-Sottoarea_22",2015,9,114,56,170
"1714","Zona_10-Area_23-Sottoarea_22",2015,10,124,64,188
"1715","Zona_10-Area_23-Sottoarea_22",2015,11,115,55,170
"1716","Zona_10-Area_23-Sottoarea_22",2015,12,116,52,168
"1717","Zona_10-Area_23-Sottoarea_22",2016,1,123,59,182
"1718","Zona_10-Area_23-Sottoarea_22",2016,2,128,54,182
"1719","Zona_10-Area_23-Sottoarea_22",2016,3,134,64,198
"1720","Zona_10-Area_23-Sottoarea_22",2016,4,115,58,173
"1721","Zona_10-Area_23-Sottoarea_22",2016,5,71,31,102
"1722","Zona_10-Area_23-Sottoarea_22",2016,6,0,0,0
"1723","Zona_10-Area_23-Sottoarea_22",2016,7,0,0,0
"1724","Zona_10-Area_23-Sottoarea_22",2016,8,0,0,0
"1725","Zona_10-Area_23-Sottoarea_22",2016,9,0,0,0
"1726","Zona_10-Area_23-Sottoarea_22",2016,10,0,0,0
"1727","Zona_10-Area_23-Sottoarea_22",2016,11,0,0,0
"1728","Zona_10-Area_23-Sottoarea_22",2016,12,0,0,0
"1729","Zona_10-Area_23-Sottoarea_23",2014,1,153,62,215
"1730","Zona_10-Area_23-Sottoarea_23",2014,2,147,68,215
"1731","Zona_10-Area_23-Sottoarea_23",2014,3,107,53,160
"1732","Zona_10-Area_23-Sottoarea_23",2014,4,124,57,181
"1733","Zona_10-Area_23-Sottoarea_23",2014,5,152,61,213
"1734","Zona_10-Area_23-Sottoarea_23",2014,6,134,54,188
"1735","Zona_10-Area_23-Sottoarea_23",2014,7,139,67,206
"1736","Zona_10-Area_23-Sottoarea_23",2014,8,100,45,145
"1737","Zona_10-Area_23-Sottoarea_23",2014,9,154,59,213
"1738","Zona_10-Area_23-Sottoarea_23",2014,10,165,92,257
"1739","Zona_10-Area_23-Sottoarea_23",2014,11,146,76,222
"1740","Zona_10-Area_23-Sottoarea_23",2014,12,148,61,209
"1741","Zona_10-Area_23-Sottoarea_23",2015,1,147,97,244
"1742","Zona_10-Area_23-Sottoarea_23",2015,2,151,76,227
"1743","Zona_10-Area_23-Sottoarea_23",2015,3,164,83,247
"1744","Zona_10-Area_23-Sottoarea_23",2015,4,148,94,242
"1745","Zona_10-Area_23-Sottoarea_23",2015,5,124,116,240
"1746","Zona_10-Area_23-Sottoarea_23",2015,6,134,67,201
"1747","Zona_10-Area_23-Sottoarea_23",2015,7,122,65,187
"1748","Zona_10-Area_23-Sottoarea_23",2015,8,104,48,152
"1749","Zona_10-Area_23-Sottoarea_23",2015,9,153,77,230
"1750","Zona_10-Area_23-Sottoarea_23",2015,10,156,88,244
"1751","Zona_10-Area_23-Sottoarea_23",2015,11,148,66,214
"1752","Zona_10-Area_23-Sottoarea_23",2015,12,158,64,222
"1753","Zona_10-Area_23-Sottoarea_23",2016,1,157,63,220
"1754","Zona_10-Area_23-Sottoarea_23",2016,2,166,79,245
"1755","Zona_10-Area_23-Sottoarea_23",2016,3,161,84,245
"1756","Zona_10-Area_23-Sottoarea_23",2016,4,162,61,223
"1757","Zona_10-Area_23-Sottoarea_23",2016,5,97,34,131
"1758","Zona_10-Area_23-Sottoarea_23",2016,6,0,0,0
"1759","Zona_10-Area_23-Sottoarea_23",2016,7,0,0,0
"1760","Zona_10-Area_23-Sottoarea_23",2016,8,0,0,0
"1761","Zona_10-Area_23-Sottoarea_23",2016,9,0,0,0
"1762","Zona_10-Area_23-Sottoarea_23",2016,10,0,0,0
"1763","Zona_10-Area_23-Sottoarea_23",2016,11,0,0,0
"1764","Zona_10-Area_23-Sottoarea_23",2016,12,0,0,0
"1765","Zona_10-Area_24-Sottoarea_28",2014,1,256,103,359
"1766","Zona_10-Area_24-Sottoarea_28",2014,2,274,116,390
"1767","Zona_10-Area_24-Sottoarea_28",2014,3,223,87,310
"1768","Zona_10-Area_24-Sottoarea_28",2014,4,242,91,333
"1769","Zona_10-Area_24-Sottoarea_28",2014,5,257,96,353
"1770","Zona_10-Area_24-Sottoarea_28",2014,6,234,92,326
"1771","Zona_10-Area_24-Sottoarea_28",2014,7,246,94,340
"1772","Zona_10-Area_24-Sottoarea_28",2014,8,184,75,259
"1773","Zona_10-Area_24-Sottoarea_28",2014,9,253,108,361
"1774","Zona_10-Area_24-Sottoarea_28",2014,10,292,135,427
"1775","Zona_10-Area_24-Sottoarea_28",2014,11,248,112,360
"1776","Zona_10-Area_24-Sottoarea_28",2014,12,223,99,322
"1777","Zona_10-Area_24-Sottoarea_28",2015,1,249,91,340
"1778","Zona_10-Area_24-Sottoarea_28",2015,2,254,205,459
"1779","Zona_10-Area_24-Sottoarea_28",2015,3,278,136,414
"1780","Zona_10-Area_24-Sottoarea_28",2015,4,254,138,392
"1781","Zona_10-Area_24-Sottoarea_28",2015,5,250,159,409
"1782","Zona_10-Area_24-Sottoarea_28",2015,6,264,108,372
"1783","Zona_10-Area_24-Sottoarea_28",2015,7,240,115,355
"1784","Zona_10-Area_24-Sottoarea_28",2015,8,175,75,250
"1785","Zona_10-Area_24-Sottoarea_28",2015,9,250,116,366
"1786","Zona_10-Area_24-Sottoarea_28",2015,10,252,150,402
"1787","Zona_10-Area_24-Sottoarea_28",2015,11,260,137,397
"1788","Zona_10-Area_24-Sottoarea_28",2015,12,246,109,355
"1789","Zona_10-Area_24-Sottoarea_28",2016,1,256,104,360
"1790","Zona_10-Area_24-Sottoarea_28",2016,2,295,134,429
"1791","Zona_10-Area_24-Sottoarea_28",2016,3,293,137,430
"1792","Zona_10-Area_24-Sottoarea_28",2016,4,248,112,360
"1793","Zona_10-Area_24-Sottoarea_28",2016,5,159,62,221
"1794","Zona_10-Area_24-Sottoarea_28",2016,6,0,0,0
"1795","Zona_10-Area_24-Sottoarea_28",2016,7,0,0,0
"1796","Zona_10-Area_24-Sottoarea_28",2016,8,0,0,0
"1797","Zona_10-Area_24-Sottoarea_28",2016,9,0,0,0
"1798","Zona_10-Area_24-Sottoarea_28",2016,10,0,0,0
"1799","Zona_10-Area_24-Sottoarea_28",2016,11,0,0,0
"1800","Zona_10-Area_24-Sottoarea_28",2016,12,0,0,0
"1801","Zona_10-Area_25-Sottoarea_29",2014,1,243,85,328
"1802","Zona_10-Area_25-Sottoarea_29",2014,2,247,100,347
"1803","Zona_10-Area_25-Sottoarea_29",2014,3,201,66,267
"1804","Zona_10-Area_25-Sottoarea_29",2014,4,208,77,285
"1805","Zona_10-Area_25-Sottoarea_29",2014,5,236,78,314
"1806","Zona_10-Area_25-Sottoarea_29",2014,6,230,75,305
"1807","Zona_10-Area_25-Sottoarea_29",2014,7,225,78,303
"1808","Zona_10-Area_25-Sottoarea_29",2014,8,194,64,258
"1809","Zona_10-Area_25-Sottoarea_29",2014,9,263,81,344
"1810","Zona_10-Area_25-Sottoarea_29",2014,10,277,123,400
"1811","Zona_10-Area_25-Sottoarea_29",2014,11,242,102,344
"1812","Zona_10-Area_25-Sottoarea_29",2014,12,216,90,306
"1813","Zona_10-Area_25-Sottoarea_29",2015,1,240,83,323
"1814","Zona_10-Area_25-Sottoarea_29",2015,2,245,171,416
"1815","Zona_10-Area_25-Sottoarea_29",2015,3,256,115,371
"1816","Zona_10-Area_25-Sottoarea_29",2015,4,258,125,383
"1817","Zona_10-Area_25-Sottoarea_29",2015,5,234,113,347
"1818","Zona_10-Area_25-Sottoarea_29",2015,6,244,94,338
"1819","Zona_10-Area_25-Sottoarea_29",2015,7,237,111,348
"1820","Zona_10-Area_25-Sottoarea_29",2015,8,184,65,249
"1821","Zona_10-Area_25-Sottoarea_29",2015,9,248,100,348
"1822","Zona_10-Area_25-Sottoarea_29",2015,10,256,124,380
"1823","Zona_10-Area_25-Sottoarea_29",2015,11,254,119,373
"1824","Zona_10-Area_25-Sottoarea_29",2015,12,242,90,332
"1825","Zona_10-Area_25-Sottoarea_29",2016,1,266,99,365
"1826","Zona_10-Area_25-Sottoarea_29",2016,2,283,103,386
"1827","Zona_10-Area_25-Sottoarea_29",2016,3,279,126,405
"1828","Zona_10-Area_25-Sottoarea_29",2016,4,253,79,332
"1829","Zona_10-Area_25-Sottoarea_29",2016,5,153,56,209
"1830","Zona_10-Area_25-Sottoarea_29",2016,6,0,0,0
"1831","Zona_10-Area_25-Sottoarea_29",2016,7,0,0,0
"1832","Zona_10-Area_25-Sottoarea_29",2016,8,0,0,0
"1833","Zona_10-Area_25-Sottoarea_29",2016,9,0,0,0
"1834","Zona_10-Area_25-Sottoarea_29",2016,10,0,0,0
"1835","Zona_10-Area_25-Sottoarea_29",2016,11,0,0,0
"1836","Zona_10-Area_25-Sottoarea_29",2016,12,0,0,0
"1837","Zona_10-Area_26-Sottoarea_66",2014,1,113,35,148
"1838","Zona_10-Area_26-Sottoarea_66",2014,2,115,43,158
"1839","Zona_10-Area_26-Sottoarea_66",2014,3,79,30,109
"1840","Zona_10-Area_26-Sottoarea_66",2014,4,93,34,127
"1841","Zona_10-Area_26-Sottoarea_66",2014,5,120,39,159
"1842","Zona_10-Area_26-Sottoarea_66",2014,6,97,29,126
"1843","Zona_10-Area_26-Sottoarea_66",2014,7,104,35,139
"1844","Zona_10-Area_26-Sottoarea_66",2014,8,86,29,115
"1845","Zona_10-Area_26-Sottoarea_66",2014,9,106,29,135
"1846","Zona_10-Area_26-Sottoarea_66",2014,10,128,57,185
"1847","Zona_10-Area_26-Sottoarea_66",2014,11,113,41,154
"1848","Zona_10-Area_26-Sottoarea_66",2014,12,120,54,174
"1849","Zona_10-Area_26-Sottoarea_66",2015,1,135,59,194
"1850","Zona_10-Area_26-Sottoarea_66",2015,2,113,74,187
"1851","Zona_10-Area_26-Sottoarea_66",2015,3,114,88,202
"1852","Zona_10-Area_26-Sottoarea_66",2015,4,96,74,170
"1853","Zona_10-Area_26-Sottoarea_66",2015,5,98,82,180
"1854","Zona_10-Area_26-Sottoarea_66",2015,6,104,56,160
"1855","Zona_10-Area_26-Sottoarea_66",2015,7,101,50,151
"1856","Zona_10-Area_26-Sottoarea_66",2015,8,65,47,112
"1857","Zona_10-Area_26-Sottoarea_66",2015,9,105,59,164
"1858","Zona_10-Area_26-Sottoarea_66",2015,10,111,65,176
"1859","Zona_10-Area_26-Sottoarea_66",2015,11,110,59,169
"1860","Zona_10-Area_26-Sottoarea_66",2015,12,95,48,143
"1861","Zona_10-Area_26-Sottoarea_66",2016,1,109,54,163
"1862","Zona_10-Area_26-Sottoarea_66",2016,2,113,64,177
"1863","Zona_10-Area_26-Sottoarea_66",2016,3,126,68,194
"1864","Zona_10-Area_26-Sottoarea_66",2016,4,110,51,161
"1865","Zona_10-Area_26-Sottoarea_66",2016,5,71,29,100
"1866","Zona_10-Area_26-Sottoarea_66",2016,6,0,0,0
"1867","Zona_10-Area_26-Sottoarea_66",2016,7,0,0,0
"1868","Zona_10-Area_26-Sottoarea_66",2016,8,0,0,0
"1869","Zona_10-Area_26-Sottoarea_66",2016,9,0,0,0
"1870","Zona_10-Area_26-Sottoarea_66",2016,10,0,0,0
"1871","Zona_10-Area_26-Sottoarea_66",2016,11,0,0,0
"1872","Zona_10-Area_26-Sottoarea_66",2016,12,0,0,0
"1873","Zona_10-Area_26-Sottoarea_67",2014,1,152,58,210
"1874","Zona_10-Area_26-Sottoarea_67",2014,2,150,59,209
"1875","Zona_10-Area_26-Sottoarea_67",2014,3,104,42,146
"1876","Zona_10-Area_26-Sottoarea_67",2014,4,121,44,165
"1877","Zona_10-Area_26-Sottoarea_67",2014,5,144,53,197
"1878","Zona_10-Area_26-Sottoarea_67",2014,6,129,43,172
"1879","Zona_10-Area_26-Sottoarea_67",2014,7,143,46,189
"1880","Zona_10-Area_26-Sottoarea_67",2014,8,104,43,147
"1881","Zona_10-Area_26-Sottoarea_67",2014,9,140,51,191
"1882","Zona_10-Area_26-Sottoarea_67",2014,10,165,67,232
"1883","Zona_10-Area_26-Sottoarea_67",2014,11,155,61,216
"1884","Zona_10-Area_26-Sottoarea_67",2014,12,147,62,209
"1885","Zona_10-Area_26-Sottoarea_67",2015,1,156,69,225
"1886","Zona_10-Area_26-Sottoarea_67",2015,2,173,80,253
"1887","Zona_10-Area_26-Sottoarea_67",2015,3,167,75,242
"1888","Zona_10-Area_26-Sottoarea_67",2015,4,144,88,232
"1889","Zona_10-Area_26-Sottoarea_67",2015,5,139,117,256
"1890","Zona_10-Area_26-Sottoarea_67",2015,6,151,60,211
"1891","Zona_10-Area_26-Sottoarea_67",2015,7,158,66,224
"1892","Zona_10-Area_26-Sottoarea_67",2015,8,116,40,156
"1893","Zona_10-Area_26-Sottoarea_67",2015,9,154,71,225
"1894","Zona_10-Area_26-Sottoarea_67",2015,10,169,76,245
"1895","Zona_10-Area_26-Sottoarea_67",2015,11,156,61,217
"1896","Zona_10-Area_26-Sottoarea_67",2015,12,161,56,217
"1897","Zona_10-Area_26-Sottoarea_67",2016,1,180,61,241
"1898","Zona_10-Area_26-Sottoarea_67",2016,2,167,64,231
"1899","Zona_10-Area_26-Sottoarea_67",2016,3,170,83,253
"1900","Zona_10-Area_26-Sottoarea_67",2016,4,165,54,219
"1901","Zona_10-Area_26-Sottoarea_67",2016,5,93,30,123
"1902","Zona_10-Area_26-Sottoarea_67",2016,6,0,0,0
"1903","Zona_10-Area_26-Sottoarea_67",2016,7,0,0,0
"1904","Zona_10-Area_26-Sottoarea_67",2016,8,0,0,0
"1905","Zona_10-Area_26-Sottoarea_67",2016,9,0,0,0
"1906","Zona_10-Area_26-Sottoarea_67",2016,10,0,0,0
"1907","Zona_10-Area_26-Sottoarea_67",2016,11,0,0,0
"1908","Zona_10-Area_26-Sottoarea_67",2016,12,0,0,0
"1909","Zona_11-Area_29-Sottoarea_45",2014,1,109,50,159
"1910","Zona_11-Area_29-Sottoarea_45",2014,2,111,62,173
"1911","Zona_11-Area_29-Sottoarea_45",2014,3,89,44,133
"1912","Zona_11-Area_29-Sottoarea_45",2014,4,107,45,152
"1913","Zona_11-Area_29-Sottoarea_45",2014,5,118,47,165
"1914","Zona_11-Area_29-Sottoarea_45",2014,6,96,42,138
"1915","Zona_11-Area_29-Sottoarea_45",2014,7,104,47,151
"1916","Zona_11-Area_29-Sottoarea_45",2014,8,80,42,122
"1917","Zona_11-Area_29-Sottoarea_45",2014,9,112,49,161
"1918","Zona_11-Area_29-Sottoarea_45",2014,10,128,72,200
"1919","Zona_11-Area_29-Sottoarea_45",2014,11,117,65,182
"1920","Zona_11-Area_29-Sottoarea_45",2014,12,110,62,172
"1921","Zona_11-Area_29-Sottoarea_45",2015,1,123,68,191
"1922","Zona_11-Area_29-Sottoarea_45",2015,2,114,74,188
"1923","Zona_11-Area_29-Sottoarea_45",2015,3,121,65,186
"1924","Zona_11-Area_29-Sottoarea_45",2015,4,103,64,167
"1925","Zona_11-Area_29-Sottoarea_45",2015,5,93,70,163
"1926","Zona_11-Area_29-Sottoarea_45",2015,6,107,75,182
"1927","Zona_11-Area_29-Sottoarea_45",2015,7,105,75,180
"1928","Zona_11-Area_29-Sottoarea_45",2015,8,72,36,108
"1929","Zona_11-Area_29-Sottoarea_45",2015,9,118,61,179
"1930","Zona_11-Area_29-Sottoarea_45",2015,10,122,80,202
"1931","Zona_11-Area_29-Sottoarea_45",2015,11,122,93,215
"1932","Zona_11-Area_29-Sottoarea_45",2015,12,128,96,224
"1933","Zona_11-Area_29-Sottoarea_45",2016,1,144,61,205
"1934","Zona_11-Area_29-Sottoarea_45",2016,2,157,61,218
"1935","Zona_11-Area_29-Sottoarea_45",2016,3,153,68,221
"1936","Zona_11-Area_29-Sottoarea_45",2016,4,134,55,189
"1937","Zona_11-Area_29-Sottoarea_45",2016,5,74,29,103
"1938","Zona_11-Area_29-Sottoarea_45",2016,6,0,0,0
"1939","Zona_11-Area_29-Sottoarea_45",2016,7,0,0,0
"1940","Zona_11-Area_29-Sottoarea_45",2016,8,0,0,0
"1941","Zona_11-Area_29-Sottoarea_45",2016,9,0,0,0
"1942","Zona_11-Area_29-Sottoarea_45",2016,10,0,0,0
"1943","Zona_11-Area_29-Sottoarea_45",2016,11,0,0,0
"1944","Zona_11-Area_29-Sottoarea_45",2016,12,0,0,0
"1945","Zona_11-Area_29-Sottoarea_46",2014,1,156,76,232
"1946","Zona_11-Area_29-Sottoarea_46",2014,2,170,84,254
"1947","Zona_11-Area_29-Sottoarea_46",2014,3,132,78,210
"1948","Zona_11-Area_29-Sottoarea_46",2014,4,158,70,228
"1949","Zona_11-Area_29-Sottoarea_46",2014,5,177,65,242
"1950","Zona_11-Area_29-Sottoarea_46",2014,6,153,63,216
"1951","Zona_11-Area_29-Sottoarea_46",2014,7,183,68,251
"1952","Zona_11-Area_29-Sottoarea_46",2014,8,115,48,163
"1953","Zona_11-Area_29-Sottoarea_46",2014,9,182,66,248
"1954","Zona_11-Area_29-Sottoarea_46",2014,10,199,105,304
"1955","Zona_11-Area_29-Sottoarea_46",2014,11,182,81,263
"1956","Zona_11-Area_29-Sottoarea_46",2014,12,142,65,207
"1957","Zona_11-Area_29-Sottoarea_46",2015,1,166,119,285
"1958","Zona_11-Area_29-Sottoarea_46",2015,2,195,87,282
"1959","Zona_11-Area_29-Sottoarea_46",2015,3,195,122,317
"1960","Zona_11-Area_29-Sottoarea_46",2015,4,161,113,274
"1961","Zona_11-Area_29-Sottoarea_46",2015,5,143,214,357
"1962","Zona_11-Area_29-Sottoarea_46",2015,6,170,96,266
"1963","Zona_11-Area_29-Sottoarea_46",2015,7,172,71,243
"1964","Zona_11-Area_29-Sottoarea_46",2015,8,109,54,163
"1965","Zona_11-Area_29-Sottoarea_46",2015,9,189,80,269
"1966","Zona_11-Area_29-Sottoarea_46",2015,10,176,99,275
"1967","Zona_11-Area_29-Sottoarea_46",2015,11,170,77,247
"1968","Zona_11-Area_29-Sottoarea_46",2015,12,160,69,229
"1969","Zona_11-Area_29-Sottoarea_46",2016,1,165,81,246
"1970","Zona_11-Area_29-Sottoarea_46",2016,2,184,84,268
"1971","Zona_11-Area_29-Sottoarea_46",2016,3,182,91,273
"1972","Zona_11-Area_29-Sottoarea_46",2016,4,178,89,267
"1973","Zona_11-Area_29-Sottoarea_46",2016,5,115,46,161
"1974","Zona_11-Area_29-Sottoarea_46",2016,6,0,0,0
"1975","Zona_11-Area_29-Sottoarea_46",2016,7,0,0,0
"1976","Zona_11-Area_29-Sottoarea_46",2016,8,0,0,0
"1977","Zona_11-Area_29-Sottoarea_46",2016,9,0,0,0
"1978","Zona_11-Area_29-Sottoarea_46",2016,10,0,0,0
"1979","Zona_11-Area_29-Sottoarea_46",2016,11,0,0,0
"1980","Zona_11-Area_29-Sottoarea_46",2016,12,0,0,0
"1981","Zona_11-Area_30-Sottoarea_83",2014,1,95,54,149
"1982","Zona_11-Area_30-Sottoarea_83",2014,2,102,55,157
"1983","Zona_11-Area_30-Sottoarea_83",2014,3,74,46,120
"1984","Zona_11-Area_30-Sottoarea_83",2014,4,90,49,139
"1985","Zona_11-Area_30-Sottoarea_83",2014,5,92,45,137
"1986","Zona_11-Area_30-Sottoarea_83",2014,6,70,43,113
"1987","Zona_11-Area_30-Sottoarea_83",2014,7,97,45,142
"1988","Zona_11-Area_30-Sottoarea_83",2014,8,63,33,96
"1989","Zona_11-Area_30-Sottoarea_83",2014,9,87,49,136
"1990","Zona_11-Area_30-Sottoarea_83",2014,10,103,57,160
"1991","Zona_11-Area_30-Sottoarea_83",2014,11,93,56,149
"1992","Zona_11-Area_30-Sottoarea_83",2014,12,73,49,122
"1993","Zona_11-Area_30-Sottoarea_83",2015,1,97,56,153
"1994","Zona_11-Area_30-Sottoarea_83",2015,2,100,84,184
"1995","Zona_11-Area_30-Sottoarea_83",2015,3,97,102,199
"1996","Zona_11-Area_30-Sottoarea_83",2015,4,83,80,163
"1997","Zona_11-Area_30-Sottoarea_83",2015,5,81,123,204
"1998","Zona_11-Area_30-Sottoarea_83",2015,6,83,72,155
"1999","Zona_11-Area_30-Sottoarea_83",2015,7,87,106,193
"2000","Zona_11-Area_30-Sottoarea_83",2015,8,58,48,106
"2001","Zona_11-Area_30-Sottoarea_83",2015,9,114,67,181
"2002","Zona_11-Area_30-Sottoarea_83",2015,10,124,88,212
"2003","Zona_11-Area_30-Sottoarea_83",2015,11,112,72,184
"2004","Zona_11-Area_30-Sottoarea_83",2015,12,121,75,196
"2005","Zona_11-Area_30-Sottoarea_83",2016,1,139,59,198
"2006","Zona_11-Area_30-Sottoarea_83",2016,2,142,81,223
"2007","Zona_11-Area_30-Sottoarea_83",2016,3,143,79,222
"2008","Zona_11-Area_30-Sottoarea_83",2016,4,135,59,194
"2009","Zona_11-Area_30-Sottoarea_83",2016,5,78,38,116
"2010","Zona_11-Area_30-Sottoarea_83",2016,6,0,0,0
"2011","Zona_11-Area_30-Sottoarea_83",2016,7,0,0,0
"2012","Zona_11-Area_30-Sottoarea_83",2016,8,0,0,0
"2013","Zona_11-Area_30-Sottoarea_83",2016,9,0,0,0
"2014","Zona_11-Area_30-Sottoarea_83",2016,10,0,0,0
"2015","Zona_11-Area_30-Sottoarea_83",2016,11,0,0,0
"2016","Zona_11-Area_30-Sottoarea_83",2016,12,0,0,0
"2017","Zona_11-Area_30-Sottoarea_84",2014,1,156,90,246
"2018","Zona_11-Area_30-Sottoarea_84",2014,2,165,89,254
"2019","Zona_11-Area_30-Sottoarea_84",2014,3,119,70,189
"2020","Zona_11-Area_30-Sottoarea_84",2014,4,136,73,209
"2021","Zona_11-Area_30-Sottoarea_84",2014,5,161,62,223
"2022","Zona_11-Area_30-Sottoarea_84",2014,6,133,64,197
"2023","Zona_11-Area_30-Sottoarea_84",2014,7,163,65,228
"2024","Zona_11-Area_30-Sottoarea_84",2014,8,105,46,151
"2025","Zona_11-Area_30-Sottoarea_84",2014,9,158,49,207
"2026","Zona_11-Area_30-Sottoarea_84",2014,10,181,77,258
"2027","Zona_11-Area_30-Sottoarea_84",2014,11,158,89,247
"2028","Zona_11-Area_30-Sottoarea_84",2014,12,144,76,220
"2029","Zona_11-Area_30-Sottoarea_84",2015,1,158,99,257
"2030","Zona_11-Area_30-Sottoarea_84",2015,2,173,157,330
"2031","Zona_11-Area_30-Sottoarea_84",2015,3,171,183,354
"2032","Zona_11-Area_30-Sottoarea_84",2015,4,154,134,288
"2033","Zona_11-Area_30-Sottoarea_84",2015,5,146,123,269
"2034","Zona_11-Area_30-Sottoarea_84",2015,6,163,116,279
"2035","Zona_11-Area_30-Sottoarea_84",2015,7,164,106,270
"2036","Zona_11-Area_30-Sottoarea_84",2015,8,109,69,178
"2037","Zona_11-Area_30-Sottoarea_84",2015,9,175,104,279
"2038","Zona_11-Area_30-Sottoarea_84",2015,10,178,115,293
"2039","Zona_11-Area_30-Sottoarea_84",2015,11,177,104,281
"2040","Zona_11-Area_30-Sottoarea_84",2015,12,173,76,249
"2041","Zona_11-Area_30-Sottoarea_84",2016,1,187,93,280
"2042","Zona_11-Area_30-Sottoarea_84",2016,2,187,129,316
"2043","Zona_11-Area_30-Sottoarea_84",2016,3,198,112,310
"2044","Zona_11-Area_30-Sottoarea_84",2016,4,177,106,283
"2045","Zona_11-Area_30-Sottoarea_84",2016,5,109,65,174
"2046","Zona_11-Area_30-Sottoarea_84",2016,6,0,0,0
"2047","Zona_11-Area_30-Sottoarea_84",2016,7,0,0,0
"2048","Zona_11-Area_30-Sottoarea_84",2016,8,0,0,0
"2049","Zona_11-Area_30-Sottoarea_84",2016,9,0,0,0
"2050","Zona_11-Area_30-Sottoarea_84",2016,10,0,0,0
"2051","Zona_11-Area_30-Sottoarea_84",2016,11,0,0,0
"2052","Zona_11-Area_30-Sottoarea_84",2016,12,0,0,0
"2053","Zona_12-Area_31-Sottoarea_43",2014,1,195,98,293
"2054","Zona_12-Area_31-Sottoarea_43",2014,2,205,109,314
"2055","Zona_12-Area_31-Sottoarea_43",2014,3,159,97,256
"2056","Zona_12-Area_31-Sottoarea_43",2014,4,173,102,275
"2057","Zona_12-Area_31-Sottoarea_43",2014,5,191,104,295
"2058","Zona_12-Area_31-Sottoarea_43",2014,6,189,96,285
"2059","Zona_12-Area_31-Sottoarea_43",2014,7,187,130,317
"2060","Zona_12-Area_31-Sottoarea_43",2014,8,129,107,236
"2061","Zona_12-Area_31-Sottoarea_43",2014,9,207,104,311
"2062","Zona_12-Area_31-Sottoarea_43",2014,10,247,147,394
"2063","Zona_12-Area_31-Sottoarea_43",2014,11,223,125,348
"2064","Zona_12-Area_31-Sottoarea_43",2014,12,190,105,295
"2065","Zona_12-Area_31-Sottoarea_43",2015,1,223,117,340
"2066","Zona_12-Area_31-Sottoarea_43",2015,2,225,182,407
"2067","Zona_12-Area_31-Sottoarea_43",2015,3,250,200,450
"2068","Zona_12-Area_31-Sottoarea_43",2015,4,210,152,362
"2069","Zona_12-Area_31-Sottoarea_43",2015,5,223,154,377
"2070","Zona_12-Area_31-Sottoarea_43",2015,6,211,141,352
"2071","Zona_12-Area_31-Sottoarea_43",2015,7,203,149,352
"2072","Zona_12-Area_31-Sottoarea_43",2015,8,146,112,258
"2073","Zona_12-Area_31-Sottoarea_43",2015,9,223,151,374
"2074","Zona_12-Area_31-Sottoarea_43",2015,10,249,183,432
"2075","Zona_12-Area_31-Sottoarea_43",2015,11,246,159,405
"2076","Zona_12-Area_31-Sottoarea_43",2015,12,249,147,396
"2077","Zona_12-Area_31-Sottoarea_43",2016,1,251,118,369
"2078","Zona_12-Area_31-Sottoarea_43",2016,2,268,172,440
"2079","Zona_12-Area_31-Sottoarea_43",2016,3,287,164,451
"2080","Zona_12-Area_31-Sottoarea_43",2016,4,254,164,418
"2081","Zona_12-Area_31-Sottoarea_43",2016,5,151,73,224
"2082","Zona_12-Area_31-Sottoarea_43",2016,6,0,0,0
"2083","Zona_12-Area_31-Sottoarea_43",2016,7,0,0,0
"2084","Zona_12-Area_31-Sottoarea_43",2016,8,0,0,0
"2085","Zona_12-Area_31-Sottoarea_43",2016,9,0,0,0
"2086","Zona_12-Area_31-Sottoarea_43",2016,10,0,0,0
"2087","Zona_12-Area_31-Sottoarea_43",2016,11,0,0,0
"2088","Zona_12-Area_31-Sottoarea_43",2016,12,0,0,0
"2089","Zona_12-Area_31-Sottoarea_44",2014,1,111,54,165
"2090","Zona_12-Area_31-Sottoarea_44",2014,2,105,52,157
"2091","Zona_12-Area_31-Sottoarea_44",2014,3,81,55,136
"2092","Zona_12-Area_31-Sottoarea_44",2014,4,97,51,148
"2093","Zona_12-Area_31-Sottoarea_44",2014,5,102,53,155
"2094","Zona_12-Area_31-Sottoarea_44",2014,6,97,57,154
"2095","Zona_12-Area_31-Sottoarea_44",2014,7,100,72,172
"2096","Zona_12-Area_31-Sottoarea_44",2014,8,64,54,118
"2097","Zona_12-Area_31-Sottoarea_44",2014,9,110,49,159
"2098","Zona_12-Area_31-Sottoarea_44",2014,10,128,89,217
"2099","Zona_12-Area_31-Sottoarea_44",2014,11,102,76,178
"2100","Zona_12-Area_31-Sottoarea_44",2014,12,100,71,171
"2101","Zona_12-Area_31-Sottoarea_44",2015,1,124,64,188
"2102","Zona_12-Area_31-Sottoarea_44",2015,2,125,75,200
"2103","Zona_12-Area_31-Sottoarea_44",2015,3,140,124,264
"2104","Zona_12-Area_31-Sottoarea_44",2015,4,141,76,217
"2105","Zona_12-Area_31-Sottoarea_44",2015,5,106,70,176
"2106","Zona_12-Area_31-Sottoarea_44",2015,6,120,70,190
"2107","Zona_12-Area_31-Sottoarea_44",2015,7,115,66,181
"2108","Zona_12-Area_31-Sottoarea_44",2015,8,82,45,127
"2109","Zona_12-Area_31-Sottoarea_44",2015,9,124,55,179
"2110","Zona_12-Area_31-Sottoarea_44",2015,10,121,72,193
"2111","Zona_12-Area_31-Sottoarea_44",2015,11,121,78,199
"2112","Zona_12-Area_31-Sottoarea_44",2015,12,124,50,174
"2113","Zona_12-Area_31-Sottoarea_44",2016,1,113,63,176
"2114","Zona_12-Area_31-Sottoarea_44",2016,2,131,81,212
"2115","Zona_12-Area_31-Sottoarea_44",2016,3,143,86,229
"2116","Zona_12-Area_31-Sottoarea_44",2016,4,134,86,220
"2117","Zona_12-Area_31-Sottoarea_44",2016,5,80,34,114
"2118","Zona_12-Area_31-Sottoarea_44",2016,6,0,0,0
"2119","Zona_12-Area_31-Sottoarea_44",2016,7,0,0,0
"2120","Zona_12-Area_31-Sottoarea_44",2016,8,0,0,0
"2121","Zona_12-Area_31-Sottoarea_44",2016,9,0,0,0
"2122","Zona_12-Area_31-Sottoarea_44",2016,10,0,0,0
"2123","Zona_12-Area_31-Sottoarea_44",2016,11,0,0,0
"2124","Zona_12-Area_31-Sottoarea_44",2016,12,0,0,0
"2125","Zona_12-Area_32-Sottoarea_140",2014,1,200,110,310
"2126","Zona_12-Area_32-Sottoarea_140",2014,2,218,102,320
"2127","Zona_12-Area_32-Sottoarea_140",2014,3,158,85,243
"2128","Zona_12-Area_32-Sottoarea_140",2014,4,180,87,267
"2129","Zona_12-Area_32-Sottoarea_140",2014,5,202,92,294
"2130","Zona_12-Area_32-Sottoarea_140",2014,6,194,84,278
"2131","Zona_12-Area_32-Sottoarea_140",2014,7,193,85,278
"2132","Zona_12-Area_32-Sottoarea_140",2014,8,137,66,203
"2133","Zona_12-Area_32-Sottoarea_140",2014,9,204,82,286
"2134","Zona_12-Area_32-Sottoarea_140",2014,10,231,125,356
"2135","Zona_12-Area_32-Sottoarea_140",2014,11,200,104,304
"2136","Zona_12-Area_32-Sottoarea_140",2014,12,175,99,274
"2137","Zona_12-Area_32-Sottoarea_140",2015,1,217,97,314
"2138","Zona_12-Area_32-Sottoarea_140",2015,2,210,175,385
"2139","Zona_12-Area_32-Sottoarea_140",2015,3,238,223,461
"2140","Zona_12-Area_32-Sottoarea_140",2015,4,181,154,335
"2141","Zona_12-Area_32-Sottoarea_140",2015,5,184,149,333
"2142","Zona_12-Area_32-Sottoarea_140",2015,6,197,117,314
"2143","Zona_12-Area_32-Sottoarea_140",2015,7,200,123,323
"2144","Zona_12-Area_32-Sottoarea_140",2015,8,147,94,241
"2145","Zona_12-Area_32-Sottoarea_140",2015,9,213,88,301
"2146","Zona_12-Area_32-Sottoarea_140",2015,10,240,140,380
"2147","Zona_12-Area_32-Sottoarea_140",2015,11,221,144,365
"2148","Zona_12-Area_32-Sottoarea_140",2015,12,205,98,303
"2149","Zona_12-Area_32-Sottoarea_140",2016,1,207,100,307
"2150","Zona_12-Area_32-Sottoarea_140",2016,2,243,138,381
"2151","Zona_12-Area_32-Sottoarea_140",2016,3,247,141,388
"2152","Zona_12-Area_32-Sottoarea_140",2016,4,209,95,304
"2153","Zona_12-Area_32-Sottoarea_140",2016,5,135,59,194
"2154","Zona_12-Area_32-Sottoarea_140",2016,6,0,0,0
"2155","Zona_12-Area_32-Sottoarea_140",2016,7,0,0,0
"2156","Zona_12-Area_32-Sottoarea_140",2016,8,0,0,0
"2157","Zona_12-Area_32-Sottoarea_140",2016,9,0,0,0
"2158","Zona_12-Area_32-Sottoarea_140",2016,10,0,0,0
"2159","Zona_12-Area_32-Sottoarea_140",2016,11,0,0,0
"2160","Zona_12-Area_32-Sottoarea_140",2016,12,0,0,0
"2161","Zona_13-Area_33-Sottoarea_9",2014,1,88,41,129
"2162","Zona_13-Area_33-Sottoarea_9",2014,2,82,42,124
"2163","Zona_13-Area_33-Sottoarea_9",2014,3,63,37,100
"2164","Zona_13-Area_33-Sottoarea_9",2014,4,77,42,119
"2165","Zona_13-Area_33-Sottoarea_9",2014,5,73,40,113
"2166","Zona_13-Area_33-Sottoarea_9",2014,6,76,31,107
"2167","Zona_13-Area_33-Sottoarea_9",2014,7,74,33,107
"2168","Zona_13-Area_33-Sottoarea_9",2014,8,52,29,81
"2169","Zona_13-Area_33-Sottoarea_9",2014,9,83,32,115
"2170","Zona_13-Area_33-Sottoarea_9",2014,10,106,45,151
"2171","Zona_13-Area_33-Sottoarea_9",2014,11,112,47,159
"2172","Zona_13-Area_33-Sottoarea_9",2014,12,83,48,131
"2173","Zona_13-Area_33-Sottoarea_9",2015,1,85,43,128
"2174","Zona_13-Area_33-Sottoarea_9",2015,2,94,58,152
"2175","Zona_13-Area_33-Sottoarea_9",2015,3,97,62,159
"2176","Zona_13-Area_33-Sottoarea_9",2015,4,114,49,163
"2177","Zona_13-Area_33-Sottoarea_9",2015,5,103,46,149
"2178","Zona_13-Area_33-Sottoarea_9",2015,6,109,33,142
"2179","Zona_13-Area_33-Sottoarea_9",2015,7,102,37,139
"2180","Zona_13-Area_33-Sottoarea_9",2015,8,73,25,98
"2181","Zona_13-Area_33-Sottoarea_9",2015,9,123,36,159
"2182","Zona_13-Area_33-Sottoarea_9",2015,10,132,47,179
"2183","Zona_13-Area_33-Sottoarea_9",2015,11,122,43,165
"2184","Zona_13-Area_33-Sottoarea_9",2015,12,91,33,124
"2185","Zona_13-Area_33-Sottoarea_9",2016,1,107,37,144
"2186","Zona_13-Area_33-Sottoarea_9",2016,2,120,38,158
"2187","Zona_13-Area_33-Sottoarea_9",2016,3,134,48,182
"2188","Zona_13-Area_33-Sottoarea_9",2016,4,109,37,146
"2189","Zona_13-Area_33-Sottoarea_9",2016,5,69,25,94
"2190","Zona_13-Area_33-Sottoarea_9",2016,6,0,0,0
"2191","Zona_13-Area_33-Sottoarea_9",2016,7,0,0,0
"2192","Zona_13-Area_33-Sottoarea_9",2016,8,0,0,0
"2193","Zona_13-Area_33-Sottoarea_9",2016,9,0,0,0
"2194","Zona_13-Area_33-Sottoarea_9",2016,10,0,0,0
"2195","Zona_13-Area_33-Sottoarea_9",2016,11,0,0,0
"2196","Zona_13-Area_33-Sottoarea_9",2016,12,0,0,0
"2197","Zona_13-Area_33-Sottoarea_10",2014,1,114,62,176
"2198","Zona_13-Area_33-Sottoarea_10",2014,2,134,85,219
"2199","Zona_13-Area_33-Sottoarea_10",2014,3,103,83,186
"2200","Zona_13-Area_33-Sottoarea_10",2014,4,114,84,198
"2201","Zona_13-Area_33-Sottoarea_10",2014,5,111,62,173
"2202","Zona_13-Area_33-Sottoarea_10",2014,6,109,57,166
"2203","Zona_13-Area_33-Sottoarea_10",2014,7,118,57,175
"2204","Zona_13-Area_33-Sottoarea_10",2014,8,76,50,126
"2205","Zona_13-Area_33-Sottoarea_10",2014,9,109,43,152
"2206","Zona_13-Area_33-Sottoarea_10",2014,10,133,58,191
"2207","Zona_13-Area_33-Sottoarea_10",2014,11,132,56,188
"2208","Zona_13-Area_33-Sottoarea_10",2014,12,96,52,148
"2209","Zona_13-Area_33-Sottoarea_10",2015,1,94,52,146
"2210","Zona_13-Area_33-Sottoarea_10",2015,2,108,68,176
"2211","Zona_13-Area_33-Sottoarea_10",2015,3,110,88,198
"2212","Zona_13-Area_33-Sottoarea_10",2015,4,104,70,174
"2213","Zona_13-Area_33-Sottoarea_10",2015,5,105,62,167
"2214","Zona_13-Area_33-Sottoarea_10",2015,6,117,62,179
"2215","Zona_13-Area_33-Sottoarea_10",2015,7,100,57,157
"2216","Zona_13-Area_33-Sottoarea_10",2015,8,87,41,128
"2217","Zona_13-Area_33-Sottoarea_10",2015,9,137,53,190
"2218","Zona_13-Area_33-Sottoarea_10",2015,10,160,67,227
"2219","Zona_13-Area_33-Sottoarea_10",2015,11,147,52,199
"2220","Zona_13-Area_33-Sottoarea_10",2015,12,119,47,166
"2221","Zona_13-Area_33-Sottoarea_10",2016,1,136,42,178
"2222","Zona_13-Area_33-Sottoarea_10",2016,2,149,68,217
"2223","Zona_13-Area_33-Sottoarea_10",2016,3,162,67,229
"2224","Zona_13-Area_33-Sottoarea_10",2016,4,130,56,186
"2225","Zona_13-Area_33-Sottoarea_10",2016,5,76,38,114
"2226","Zona_13-Area_33-Sottoarea_10",2016,6,0,0,0
"2227","Zona_13-Area_33-Sottoarea_10",2016,7,0,0,0
"2228","Zona_13-Area_33-Sottoarea_10",2016,8,0,0,0
"2229","Zona_13-Area_33-Sottoarea_10",2016,9,0,0,0
"2230","Zona_13-Area_33-Sottoarea_10",2016,10,0,0,0
"2231","Zona_13-Area_33-Sottoarea_10",2016,11,0,0,0
"2232","Zona_13-Area_33-Sottoarea_10",2016,12,0,0,0
"2233","Zona_13-Area_34-Sottoarea_64",2014,1,167,82,249
"2234","Zona_13-Area_34-Sottoarea_64",2014,2,174,107,281
"2235","Zona_13-Area_34-Sottoarea_64",2014,3,139,85,224
"2236","Zona_13-Area_34-Sottoarea_64",2014,4,149,88,237
"2237","Zona_13-Area_34-Sottoarea_64",2014,5,151,96,247
"2238","Zona_13-Area_34-Sottoarea_64",2014,6,136,80,216
"2239","Zona_13-Area_34-Sottoarea_64",2014,7,135,74,209
"2240","Zona_13-Area_34-Sottoarea_64",2014,8,109,71,180
"2241","Zona_13-Area_34-Sottoarea_64",2014,9,151,71,222
"2242","Zona_13-Area_34-Sottoarea_64",2014,10,183,108,291
"2243","Zona_13-Area_34-Sottoarea_64",2014,11,176,93,269
"2244","Zona_13-Area_34-Sottoarea_64",2014,12,140,92,232
"2245","Zona_13-Area_34-Sottoarea_64",2015,1,144,116,260
"2246","Zona_13-Area_34-Sottoarea_64",2015,2,151,138,289
"2247","Zona_13-Area_34-Sottoarea_64",2015,3,166,164,330
"2248","Zona_13-Area_34-Sottoarea_64",2015,4,151,118,269
"2249","Zona_13-Area_34-Sottoarea_64",2015,5,134,102,236
"2250","Zona_13-Area_34-Sottoarea_64",2015,6,150,88,238
"2251","Zona_13-Area_34-Sottoarea_64",2015,7,151,91,242
"2252","Zona_13-Area_34-Sottoarea_64",2015,8,118,60,178
"2253","Zona_13-Area_34-Sottoarea_64",2015,9,208,79,287
"2254","Zona_13-Area_34-Sottoarea_64",2015,10,234,110,344
"2255","Zona_13-Area_34-Sottoarea_64",2015,11,216,108,324
"2256","Zona_13-Area_34-Sottoarea_64",2015,12,182,90,272
"2257","Zona_13-Area_34-Sottoarea_64",2016,1,203,85,288
"2258","Zona_13-Area_34-Sottoarea_64",2016,2,223,100,323
"2259","Zona_13-Area_34-Sottoarea_64",2016,3,241,110,351
"2260","Zona_13-Area_34-Sottoarea_64",2016,4,224,89,313
"2261","Zona_13-Area_34-Sottoarea_64",2016,5,133,63,196
"2262","Zona_13-Area_34-Sottoarea_64",2016,6,0,0,0
"2263","Zona_13-Area_34-Sottoarea_64",2016,7,0,0,0
"2264","Zona_13-Area_34-Sottoarea_64",2016,8,0,0,0
"2265","Zona_13-Area_34-Sottoarea_64",2016,9,0,0,0
"2266","Zona_13-Area_34-Sottoarea_64",2016,10,0,0,0
"2267","Zona_13-Area_34-Sottoarea_64",2016,11,0,0,0
"2268","Zona_13-Area_34-Sottoarea_64",2016,12,0,0,0
"2269","Zona_13-Area_34-Sottoarea_65",2014,1,26,12,38
"2270","Zona_13-Area_34-Sottoarea_65",2014,2,21,9,30
"2271","Zona_13-Area_34-Sottoarea_65",2014,3,16,14,30
"2272","Zona_13-Area_34-Sottoarea_65",2014,4,22,14,36
"2273","Zona_13-Area_34-Sottoarea_65",2014,5,20,14,34
"2274","Zona_13-Area_34-Sottoarea_65",2014,6,19,13,32
"2275","Zona_13-Area_34-Sottoarea_65",2014,7,21,15,36
"2276","Zona_13-Area_34-Sottoarea_65",2014,8,17,9,26
"2277","Zona_13-Area_34-Sottoarea_65",2014,9,23,5,28
"2278","Zona_13-Area_34-Sottoarea_65",2014,10,24,12,36
"2279","Zona_13-Area_34-Sottoarea_65",2014,11,22,16,38
"2280","Zona_13-Area_34-Sottoarea_65",2014,12,18,8,26
"2281","Zona_13-Area_34-Sottoarea_65",2015,1,20,12,32
"2282","Zona_13-Area_34-Sottoarea_65",2015,2,19,18,37
"2283","Zona_13-Area_34-Sottoarea_65",2015,3,23,30,53
"2284","Zona_13-Area_34-Sottoarea_65",2015,4,23,17,40
"2285","Zona_13-Area_34-Sottoarea_65",2015,5,19,8,27
"2286","Zona_13-Area_34-Sottoarea_65",2015,6,24,15,39
"2287","Zona_13-Area_34-Sottoarea_65",2015,7,22,7,29
"2288","Zona_13-Area_34-Sottoarea_65",2015,8,19,5,24
"2289","Zona_13-Area_34-Sottoarea_65",2015,9,25,12,37
"2290","Zona_13-Area_34-Sottoarea_65",2015,10,25,17,42
"2291","Zona_13-Area_34-Sottoarea_65",2015,11,23,21,44
"2292","Zona_13-Area_34-Sottoarea_65",2015,12,20,13,33
"2293","Zona_13-Area_34-Sottoarea_65",2016,1,25,11,36
"2294","Zona_13-Area_34-Sottoarea_65",2016,2,27,11,38
"2295","Zona_13-Area_34-Sottoarea_65",2016,3,27,16,43
"2296","Zona_13-Area_34-Sottoarea_65",2016,4,20,10,30
"2297","Zona_13-Area_34-Sottoarea_65",2016,5,14,9,23
"2298","Zona_13-Area_34-Sottoarea_65",2016,6,0,0,0
"2299","Zona_13-Area_34-Sottoarea_65",2016,7,0,0,0
"2300","Zona_13-Area_34-Sottoarea_65",2016,8,0,0,0
"2301","Zona_13-Area_34-Sottoarea_65",2016,9,0,0,0
"2302","Zona_13-Area_34-Sottoarea_65",2016,10,0,0,0
"2303","Zona_13-Area_34-Sottoarea_65",2016,11,0,0,0
"2304","Zona_13-Area_34-Sottoarea_65",2016,12,0,0,0
"2305","Zona_14-Area_35-Sottoarea_70",2014,1,117,24,141
"2306","Zona_14-Area_35-Sottoarea_70",2014,2,124,25,149
"2307","Zona_14-Area_35-Sottoarea_70",2014,3,97,21,118
"2308","Zona_14-Area_35-Sottoarea_70",2014,4,116,22,138
"2309","Zona_14-Area_35-Sottoarea_70",2014,5,131,22,153
"2310","Zona_14-Area_35-Sottoarea_70",2014,6,119,24,143
"2311","Zona_14-Area_35-Sottoarea_70",2014,7,132,26,158
"2312","Zona_14-Area_35-Sottoarea_70",2014,8,65,14,79
"2313","Zona_14-Area_35-Sottoarea_70",2014,9,112,20,132
"2314","Zona_14-Area_35-Sottoarea_70",2014,10,157,25,182
"2315","Zona_14-Area_35-Sottoarea_70",2014,11,117,26,143
"2316","Zona_14-Area_35-Sottoarea_70",2014,12,109,23,132
"2317","Zona_14-Area_35-Sottoarea_70",2015,1,109,21,130
"2318","Zona_14-Area_35-Sottoarea_70",2015,2,109,28,137
"2319","Zona_14-Area_35-Sottoarea_70",2015,3,121,29,150
"2320","Zona_14-Area_35-Sottoarea_70",2015,4,102,34,136
"2321","Zona_14-Area_35-Sottoarea_70",2015,5,96,34,130
"2322","Zona_14-Area_35-Sottoarea_70",2015,6,97,21,118
"2323","Zona_14-Area_35-Sottoarea_70",2015,7,114,27,141
"2324","Zona_14-Area_35-Sottoarea_70",2015,8,61,13,74
"2325","Zona_14-Area_35-Sottoarea_70",2015,9,109,18,127
"2326","Zona_14-Area_35-Sottoarea_70",2015,10,128,25,153
"2327","Zona_14-Area_35-Sottoarea_70",2015,11,114,27,141
"2328","Zona_14-Area_35-Sottoarea_70",2015,12,96,17,113
"2329","Zona_14-Area_35-Sottoarea_70",2016,1,97,19,116
"2330","Zona_14-Area_35-Sottoarea_70",2016,2,108,28,136
"2331","Zona_14-Area_35-Sottoarea_70",2016,3,118,25,143
"2332","Zona_14-Area_35-Sottoarea_70",2016,4,97,39,136
"2333","Zona_14-Area_35-Sottoarea_70",2016,5,72,12,84
"2334","Zona_14-Area_35-Sottoarea_70",2016,6,0,0,0
"2335","Zona_14-Area_35-Sottoarea_70",2016,7,0,0,0
"2336","Zona_14-Area_35-Sottoarea_70",2016,8,0,0,0
"2337","Zona_14-Area_35-Sottoarea_70",2016,9,0,0,0
"2338","Zona_14-Area_35-Sottoarea_70",2016,10,0,0,0
"2339","Zona_14-Area_35-Sottoarea_70",2016,11,0,0,0
"2340","Zona_14-Area_35-Sottoarea_70",2016,12,0,0,0
"2341","Zona_14-Area_35-Sottoarea_71",2014,1,67,25,92
"2342","Zona_14-Area_35-Sottoarea_71",2014,2,72,23,95
"2343","Zona_14-Area_35-Sottoarea_71",2014,3,57,23,80
"2344","Zona_14-Area_35-Sottoarea_71",2014,4,71,24,95
"2345","Zona_14-Area_35-Sottoarea_71",2014,5,78,24,102
"2346","Zona_14-Area_35-Sottoarea_71",2014,6,66,23,89
"2347","Zona_14-Area_35-Sottoarea_71",2014,7,63,20,83
"2348","Zona_14-Area_35-Sottoarea_71",2014,8,33,14,47
"2349","Zona_14-Area_35-Sottoarea_71",2014,9,57,18,75
"2350","Zona_14-Area_35-Sottoarea_71",2014,10,81,24,105
"2351","Zona_14-Area_35-Sottoarea_71",2014,11,71,21,92
"2352","Zona_14-Area_35-Sottoarea_71",2014,12,59,22,81
"2353","Zona_14-Area_35-Sottoarea_71",2015,1,64,21,85
"2354","Zona_14-Area_35-Sottoarea_71",2015,2,69,26,95
"2355","Zona_14-Area_35-Sottoarea_71",2015,3,78,28,106
"2356","Zona_14-Area_35-Sottoarea_71",2015,4,68,26,94
"2357","Zona_14-Area_35-Sottoarea_71",2015,5,61,27,88
"2358","Zona_14-Area_35-Sottoarea_71",2015,6,59,21,80
"2359","Zona_14-Area_35-Sottoarea_71",2015,7,68,16,84
"2360","Zona_14-Area_35-Sottoarea_71",2015,8,37,12,49
"2361","Zona_14-Area_35-Sottoarea_71",2015,9,72,19,91
"2362","Zona_14-Area_35-Sottoarea_71",2015,10,82,21,103
"2363","Zona_14-Area_35-Sottoarea_71",2015,11,79,28,107
"2364","Zona_14-Area_35-Sottoarea_71",2015,12,58,17,75
"2365","Zona_14-Area_35-Sottoarea_71",2016,1,58,14,72
"2366","Zona_14-Area_35-Sottoarea_71",2016,2,63,19,82
"2367","Zona_14-Area_35-Sottoarea_71",2016,3,64,33,97
"2368","Zona_14-Area_35-Sottoarea_71",2016,4,66,40,106
"2369","Zona_14-Area_35-Sottoarea_71",2016,5,52,10,62
"2370","Zona_14-Area_35-Sottoarea_71",2016,6,0,0,0
"2371","Zona_14-Area_35-Sottoarea_71",2016,7,0,0,0
"2372","Zona_14-Area_35-Sottoarea_71",2016,8,0,0,0
"2373","Zona_14-Area_35-Sottoarea_71",2016,9,0,0,0
"2374","Zona_14-Area_35-Sottoarea_71",2016,10,0,0,0
"2375","Zona_14-Area_35-Sottoarea_71",2016,11,0,0,0
"2376","Zona_14-Area_35-Sottoarea_71",2016,12,0,0,0
"2377","Zona_14-Area_35-Sottoarea_72",2014,1,54,8,62
"2378","Zona_14-Area_35-Sottoarea_72",2014,2,59,10,69
"2379","Zona_14-Area_35-Sottoarea_72",2014,3,51,5,56
"2380","Zona_14-Area_35-Sottoarea_72",2014,4,55,9,64
"2381","Zona_14-Area_35-Sottoarea_72",2014,5,58,7,65
"2382","Zona_14-Area_35-Sottoarea_72",2014,6,54,11,65
"2383","Zona_14-Area_35-Sottoarea_72",2014,7,54,4,58
"2384","Zona_14-Area_35-Sottoarea_72",2014,8,28,3,31
"2385","Zona_14-Area_35-Sottoarea_72",2014,9,70,3,73
"2386","Zona_14-Area_35-Sottoarea_72",2014,10,88,14,102
"2387","Zona_14-Area_35-Sottoarea_72",2014,11,72,13,85
"2388","Zona_14-Area_35-Sottoarea_72",2014,12,57,10,67
"2389","Zona_14-Area_35-Sottoarea_72",2015,1,55,5,60
"2390","Zona_14-Area_35-Sottoarea_72",2015,2,55,12,67
"2391","Zona_14-Area_35-Sottoarea_72",2015,3,64,14,78
"2392","Zona_14-Area_35-Sottoarea_72",2015,4,58,14,72
"2393","Zona_14-Area_35-Sottoarea_72",2015,5,57,16,73
"2394","Zona_14-Area_35-Sottoarea_72",2015,6,51,13,64
"2395","Zona_14-Area_35-Sottoarea_72",2015,7,50,13,63
"2396","Zona_14-Area_35-Sottoarea_72",2015,8,33,5,38
"2397","Zona_14-Area_35-Sottoarea_72",2015,9,74,9,83
"2398","Zona_14-Area_35-Sottoarea_72",2015,10,78,11,89
"2399","Zona_14-Area_35-Sottoarea_72",2015,11,57,13,70
"2400","Zona_14-Area_35-Sottoarea_72",2015,12,46,6,52
"2401","Zona_14-Area_35-Sottoarea_72",2016,1,47,10,57
"2402","Zona_14-Area_35-Sottoarea_72",2016,2,53,4,57
"2403","Zona_14-Area_35-Sottoarea_72",2016,3,55,5,60
"2404","Zona_14-Area_35-Sottoarea_72",2016,4,49,8,57
"2405","Zona_14-Area_35-Sottoarea_72",2016,5,41,0,41
"2406","Zona_14-Area_35-Sottoarea_72",2016,6,0,0,0
"2407","Zona_14-Area_35-Sottoarea_72",2016,7,0,0,0
"2408","Zona_14-Area_35-Sottoarea_72",2016,8,0,0,0
"2409","Zona_14-Area_35-Sottoarea_72",2016,9,0,0,0
"2410","Zona_14-Area_35-Sottoarea_72",2016,10,0,0,0
"2411","Zona_14-Area_35-Sottoarea_72",2016,11,0,0,0
"2412","Zona_14-Area_35-Sottoarea_72",2016,12,0,0,0
"2413","Zona_14-Area_36-Sottoarea_73",2014,1,89,39,128
"2414","Zona_14-Area_36-Sottoarea_73",2014,2,105,40,145
"2415","Zona_14-Area_36-Sottoarea_73",2014,3,79,36,115
"2416","Zona_14-Area_36-Sottoarea_73",2014,4,102,33,135
"2417","Zona_14-Area_36-Sottoarea_73",2014,5,98,36,134
"2418","Zona_14-Area_36-Sottoarea_73",2014,6,91,28,119
"2419","Zona_14-Area_36-Sottoarea_73",2014,7,90,36,126
"2420","Zona_14-Area_36-Sottoarea_73",2014,8,71,25,96
"2421","Zona_14-Area_36-Sottoarea_73",2014,9,102,24,126
"2422","Zona_14-Area_36-Sottoarea_73",2014,10,134,37,171
"2423","Zona_14-Area_36-Sottoarea_73",2014,11,100,38,138
"2424","Zona_14-Area_36-Sottoarea_73",2014,12,87,41,128
"2425","Zona_14-Area_36-Sottoarea_73",2015,1,107,34,141
"2426","Zona_14-Area_36-Sottoarea_73",2015,2,105,45,150
"2427","Zona_14-Area_36-Sottoarea_73",2015,3,126,49,175
"2428","Zona_14-Area_36-Sottoarea_73",2015,4,116,81,197
"2429","Zona_14-Area_36-Sottoarea_73",2015,5,97,62,159
"2430","Zona_14-Area_36-Sottoarea_73",2015,6,93,60,153
"2431","Zona_14-Area_36-Sottoarea_73",2015,7,90,52,142
"2432","Zona_14-Area_36-Sottoarea_73",2015,8,68,29,97
"2433","Zona_14-Area_36-Sottoarea_73",2015,9,123,40,163
"2434","Zona_14-Area_36-Sottoarea_73",2015,10,122,51,173
"2435","Zona_14-Area_36-Sottoarea_73",2015,11,126,37,163
"2436","Zona_14-Area_36-Sottoarea_73",2015,12,108,38,146
"2437","Zona_14-Area_36-Sottoarea_73",2016,1,118,31,149
"2438","Zona_14-Area_36-Sottoarea_73",2016,2,113,36,149
"2439","Zona_14-Area_36-Sottoarea_73",2016,3,115,43,158
"2440","Zona_14-Area_36-Sottoarea_73",2016,4,110,79,189
"2441","Zona_14-Area_36-Sottoarea_73",2016,5,58,21,79
"2442","Zona_14-Area_36-Sottoarea_73",2016,6,0,0,0
"2443","Zona_14-Area_36-Sottoarea_73",2016,7,0,0,0
"2444","Zona_14-Area_36-Sottoarea_73",2016,8,0,0,0
"2445","Zona_14-Area_36-Sottoarea_73",2016,9,0,0,0
"2446","Zona_14-Area_36-Sottoarea_73",2016,10,0,0,0
"2447","Zona_14-Area_36-Sottoarea_73",2016,11,0,0,0
"2448","Zona_14-Area_36-Sottoarea_73",2016,12,0,0,0
"2449","Zona_14-Area_36-Sottoarea_74",2014,1,132,75,207
"2450","Zona_14-Area_36-Sottoarea_74",2014,2,177,71,248
"2451","Zona_14-Area_36-Sottoarea_74",2014,3,118,68,186
"2452","Zona_14-Area_36-Sottoarea_74",2014,4,141,68,209
"2453","Zona_14-Area_36-Sottoarea_74",2014,5,145,67,212
"2454","Zona_14-Area_36-Sottoarea_74",2014,6,133,53,186
"2455","Zona_14-Area_36-Sottoarea_74",2014,7,135,66,201
"2456","Zona_14-Area_36-Sottoarea_74",2014,8,97,41,138
"2457","Zona_14-Area_36-Sottoarea_74",2014,9,147,51,198
"2458","Zona_14-Area_36-Sottoarea_74",2014,10,168,83,251
"2459","Zona_14-Area_36-Sottoarea_74",2014,11,137,69,206
"2460","Zona_14-Area_36-Sottoarea_74",2014,12,145,67,212
"2461","Zona_14-Area_36-Sottoarea_74",2015,1,150,83,233
"2462","Zona_14-Area_36-Sottoarea_74",2015,2,155,89,244
"2463","Zona_14-Area_36-Sottoarea_74",2015,3,142,89,231
"2464","Zona_14-Area_36-Sottoarea_74",2015,4,128,103,231
"2465","Zona_14-Area_36-Sottoarea_74",2015,5,146,108,254
"2466","Zona_14-Area_36-Sottoarea_74",2015,6,137,79,216
"2467","Zona_14-Area_36-Sottoarea_74",2015,7,137,83,220
"2468","Zona_14-Area_36-Sottoarea_74",2015,8,102,46,148
"2469","Zona_14-Area_36-Sottoarea_74",2015,9,160,78,238
"2470","Zona_14-Area_36-Sottoarea_74",2015,10,160,94,254
"2471","Zona_14-Area_36-Sottoarea_74",2015,11,150,88,238
"2472","Zona_14-Area_36-Sottoarea_74",2015,12,153,78,231
"2473","Zona_14-Area_36-Sottoarea_74",2016,1,162,86,248
"2474","Zona_14-Area_36-Sottoarea_74",2016,2,166,95,261
"2475","Zona_14-Area_36-Sottoarea_74",2016,3,177,98,275
"2476","Zona_14-Area_36-Sottoarea_74",2016,4,161,88,249
"2477","Zona_14-Area_36-Sottoarea_74",2016,5,95,49,144
"2478","Zona_14-Area_36-Sottoarea_74",2016,6,0,0,0
"2479","Zona_14-Area_36-Sottoarea_74",2016,7,0,0,0
"2480","Zona_14-Area_36-Sottoarea_74",2016,8,0,0,0
"2481","Zona_14-Area_36-Sottoarea_74",2016,9,0,0,0
"2482","Zona_14-Area_36-Sottoarea_74",2016,10,0,0,0
"2483","Zona_14-Area_36-Sottoarea_74",2016,11,0,0,0
"2484","Zona_14-Area_36-Sottoarea_74",2016,12,0,0,0
"2485","Zona_14-Area_37-Sottoarea_75",2014,1,118,52,170
"2486","Zona_14-Area_37-Sottoarea_75",2014,2,120,60,180
"2487","Zona_14-Area_37-Sottoarea_75",2014,3,85,44,129
"2488","Zona_14-Area_37-Sottoarea_75",2014,4,102,54,156
"2489","Zona_14-Area_37-Sottoarea_75",2014,5,113,46,159
"2490","Zona_14-Area_37-Sottoarea_75",2014,6,104,40,144
"2491","Zona_14-Area_37-Sottoarea_75",2014,7,104,43,147
"2492","Zona_14-Area_37-Sottoarea_75",2014,8,87,34,121
"2493","Zona_14-Area_37-Sottoarea_75",2014,9,111,38,149
"2494","Zona_14-Area_37-Sottoarea_75",2014,10,129,58,187
"2495","Zona_14-Area_37-Sottoarea_75",2014,11,112,50,162
"2496","Zona_14-Area_37-Sottoarea_75",2014,12,107,48,155
"2497","Zona_14-Area_37-Sottoarea_75",2015,1,127,66,193
"2498","Zona_14-Area_37-Sottoarea_75",2015,2,120,98,218
"2499","Zona_14-Area_37-Sottoarea_75",2015,3,125,113,238
"2500","Zona_14-Area_37-Sottoarea_75",2015,4,109,80,189
"2501","Zona_14-Area_37-Sottoarea_75",2015,5,115,81,196
"2502","Zona_14-Area_37-Sottoarea_75",2015,6,114,69,183
"2503","Zona_14-Area_37-Sottoarea_75",2015,7,107,88,195
"2504","Zona_14-Area_37-Sottoarea_75",2015,8,86,73,159
"2505","Zona_14-Area_37-Sottoarea_75",2015,9,146,74,220
"2506","Zona_14-Area_37-Sottoarea_75",2015,10,150,78,228
"2507","Zona_14-Area_37-Sottoarea_75",2015,11,136,74,210
"2508","Zona_14-Area_37-Sottoarea_75",2015,12,118,54,172
"2509","Zona_14-Area_37-Sottoarea_75",2016,1,126,65,191
"2510","Zona_14-Area_37-Sottoarea_75",2016,2,144,79,223
"2511","Zona_14-Area_37-Sottoarea_75",2016,3,149,89,238
"2512","Zona_14-Area_37-Sottoarea_75",2016,4,135,59,194
"2513","Zona_14-Area_37-Sottoarea_75",2016,5,81,39,120
"2514","Zona_14-Area_37-Sottoarea_75",2016,6,0,0,0
"2515","Zona_14-Area_37-Sottoarea_75",2016,7,0,0,0
"2516","Zona_14-Area_37-Sottoarea_75",2016,8,0,0,0
"2517","Zona_14-Area_37-Sottoarea_75",2016,9,0,0,0
"2518","Zona_14-Area_37-Sottoarea_75",2016,10,0,0,0
"2519","Zona_14-Area_37-Sottoarea_75",2016,11,0,0,0
"2520","Zona_14-Area_37-Sottoarea_75",2016,12,0,0,0
"2521","Zona_14-Area_37-Sottoarea_76",2014,1,154,78,232
"2522","Zona_14-Area_37-Sottoarea_76",2014,2,161,76,237
"2523","Zona_14-Area_37-Sottoarea_76",2014,3,120,55,175
"2524","Zona_14-Area_37-Sottoarea_76",2014,4,148,62,210
"2525","Zona_14-Area_37-Sottoarea_76",2014,5,149,62,211
"2526","Zona_14-Area_37-Sottoarea_76",2014,6,131,55,186
"2527","Zona_14-Area_37-Sottoarea_76",2014,7,144,56,200
"2528","Zona_14-Area_37-Sottoarea_76",2014,8,112,39,151
"2529","Zona_14-Area_37-Sottoarea_76",2014,9,180,52,232
"2530","Zona_14-Area_37-Sottoarea_76",2014,10,219,70,289
"2531","Zona_14-Area_37-Sottoarea_76",2014,11,194,60,254
"2532","Zona_14-Area_37-Sottoarea_76",2014,12,174,58,232
"2533","Zona_14-Area_37-Sottoarea_76",2015,1,187,63,250
"2534","Zona_14-Area_37-Sottoarea_76",2015,2,208,121,329
"2535","Zona_14-Area_37-Sottoarea_76",2015,3,201,87,288
"2536","Zona_14-Area_37-Sottoarea_76",2015,4,204,92,296
"2537","Zona_14-Area_37-Sottoarea_76",2015,5,198,104,302
"2538","Zona_14-Area_37-Sottoarea_76",2015,6,187,72,259
"2539","Zona_14-Area_37-Sottoarea_76",2015,7,180,71,251
"2540","Zona_14-Area_37-Sottoarea_76",2015,8,126,56,182
"2541","Zona_14-Area_37-Sottoarea_76",2015,9,208,66,274
"2542","Zona_14-Area_37-Sottoarea_76",2015,10,241,94,335
"2543","Zona_14-Area_37-Sottoarea_76",2015,11,217,80,297
"2544","Zona_14-Area_37-Sottoarea_76",2015,12,192,61,253
"2545","Zona_14-Area_37-Sottoarea_76",2016,1,191,75,266
"2546","Zona_14-Area_37-Sottoarea_76",2016,2,208,92,300
"2547","Zona_14-Area_37-Sottoarea_76",2016,3,205,88,293
"2548","Zona_14-Area_37-Sottoarea_76",2016,4,187,59,246
"2549","Zona_14-Area_37-Sottoarea_76",2016,5,112,41,153
"2550","Zona_14-Area_37-Sottoarea_76",2016,6,0,0,0
"2551","Zona_14-Area_37-Sottoarea_76",2016,7,0,0,0
"2552","Zona_14-Area_37-Sottoarea_76",2016,8,0,0,0
"2553","Zona_14-Area_37-Sottoarea_76",2016,9,0,0,0
"2554","Zona_14-Area_37-Sottoarea_76",2016,10,0,0,0
"2555","Zona_14-Area_37-Sottoarea_76",2016,11,0,0,0
"2556","Zona_14-Area_37-Sottoarea_76",2016,12,0,0,0
"2557","Zona_14-Area_38-Sottoarea_77",2014,1,152,67,219
"2558","Zona_14-Area_38-Sottoarea_77",2014,2,169,63,232
"2559","Zona_14-Area_38-Sottoarea_77",2014,3,121,57,178
"2560","Zona_14-Area_38-Sottoarea_77",2014,4,158,61,219
"2561","Zona_14-Area_38-Sottoarea_77",2014,5,156,57,213
"2562","Zona_14-Area_38-Sottoarea_77",2014,6,143,49,192
"2563","Zona_14-Area_38-Sottoarea_77",2014,7,150,54,204
"2564","Zona_14-Area_38-Sottoarea_77",2014,8,94,40,134
"2565","Zona_14-Area_38-Sottoarea_77",2014,9,172,43,215
"2566","Zona_14-Area_38-Sottoarea_77",2014,10,213,62,275
"2567","Zona_14-Area_38-Sottoarea_77",2014,11,185,60,245
"2568","Zona_14-Area_38-Sottoarea_77",2014,12,185,58,243
"2569","Zona_14-Area_38-Sottoarea_77",2015,1,174,59,233
"2570","Zona_14-Area_38-Sottoarea_77",2015,2,179,74,253
"2571","Zona_14-Area_38-Sottoarea_77",2015,3,194,86,280
"2572","Zona_14-Area_38-Sottoarea_77",2015,4,164,86,250
"2573","Zona_14-Area_38-Sottoarea_77",2015,5,157,87,244
"2574","Zona_14-Area_38-Sottoarea_77",2015,6,165,87,252
"2575","Zona_14-Area_38-Sottoarea_77",2015,7,158,88,246
"2576","Zona_14-Area_38-Sottoarea_77",2015,8,102,45,147
"2577","Zona_14-Area_38-Sottoarea_77",2015,9,186,68,254
"2578","Zona_14-Area_38-Sottoarea_77",2015,10,192,91,283
"2579","Zona_14-Area_38-Sottoarea_77",2015,11,184,66,250
"2580","Zona_14-Area_38-Sottoarea_77",2015,12,176,60,236
"2581","Zona_14-Area_38-Sottoarea_77",2016,1,184,59,243
"2582","Zona_14-Area_38-Sottoarea_77",2016,2,194,87,281
"2583","Zona_14-Area_38-Sottoarea_77",2016,3,209,157,366
"2584","Zona_14-Area_38-Sottoarea_77",2016,4,176,186,362
"2585","Zona_14-Area_38-Sottoarea_77",2016,5,114,83,197
"2586","Zona_14-Area_38-Sottoarea_77",2016,6,0,0,0
"2587","Zona_14-Area_38-Sottoarea_77",2016,7,0,0,0
"2588","Zona_14-Area_38-Sottoarea_77",2016,8,0,0,0
"2589","Zona_14-Area_38-Sottoarea_77",2016,9,0,0,0
"2590","Zona_14-Area_38-Sottoarea_77",2016,10,0,0,0
"2591","Zona_14-Area_38-Sottoarea_77",2016,11,0,0,0
"2592","Zona_14-Area_38-Sottoarea_77",2016,12,0,0,0
"2593","Zona_14-Area_38-Sottoarea_78",2014,1,17,4,21
"2594","Zona_14-Area_38-Sottoarea_78",2014,2,20,5,25
"2595","Zona_14-Area_38-Sottoarea_78",2014,3,14,6,20
"2596","Zona_14-Area_38-Sottoarea_78",2014,4,15,4,19
"2597","Zona_14-Area_38-Sottoarea_78",2014,5,19,4,23
"2598","Zona_14-Area_38-Sottoarea_78",2014,6,12,6,18
"2599","Zona_14-Area_38-Sottoarea_78",2014,7,15,3,18
"2600","Zona_14-Area_38-Sottoarea_78",2014,8,10,1,11
"2601","Zona_14-Area_38-Sottoarea_78",2014,9,19,1,20
"2602","Zona_14-Area_38-Sottoarea_78",2014,10,24,3,27
"2603","Zona_14-Area_38-Sottoarea_78",2014,11,20,4,24
"2604","Zona_14-Area_38-Sottoarea_78",2014,12,14,1,15
"2605","Zona_14-Area_38-Sottoarea_78",2015,1,19,2,21
"2606","Zona_14-Area_38-Sottoarea_78",2015,2,19,1,20
"2607","Zona_14-Area_38-Sottoarea_78",2015,3,16,2,18
"2608","Zona_14-Area_38-Sottoarea_78",2015,4,18,5,23
"2609","Zona_14-Area_38-Sottoarea_78",2015,5,15,3,18
"2610","Zona_14-Area_38-Sottoarea_78",2015,6,16,2,18
"2611","Zona_14-Area_38-Sottoarea_78",2015,7,18,1,19
"2612","Zona_14-Area_38-Sottoarea_78",2015,8,10,0,10
"2613","Zona_14-Area_38-Sottoarea_78",2015,9,19,1,20
"2614","Zona_14-Area_38-Sottoarea_78",2015,10,22,1,23
"2615","Zona_14-Area_38-Sottoarea_78",2015,11,18,0,18
"2616","Zona_14-Area_38-Sottoarea_78",2015,12,19,0,19
"2617","Zona_14-Area_38-Sottoarea_78",2016,1,14,1,15
"2618","Zona_14-Area_38-Sottoarea_78",2016,2,18,2,20
"2619","Zona_14-Area_38-Sottoarea_78",2016,3,19,4,23
"2620","Zona_14-Area_38-Sottoarea_78",2016,4,14,1,15
"2621","Zona_14-Area_38-Sottoarea_78",2016,5,10,0,10
"2622","Zona_14-Area_38-Sottoarea_78",2016,6,0,0,0
"2623","Zona_14-Area_38-Sottoarea_78",2016,7,0,0,0
"2624","Zona_14-Area_38-Sottoarea_78",2016,8,0,0,0
"2625","Zona_14-Area_38-Sottoarea_78",2016,9,0,0,0
"2626","Zona_14-Area_38-Sottoarea_78",2016,10,0,0,0
"2627","Zona_14-Area_38-Sottoarea_78",2016,11,0,0,0
"2628","Zona_14-Area_38-Sottoarea_78",2016,12,0,0,0
"2629","Zona_14-Area_38-Sottoarea_79",2014,1,87,21,108
"2630","Zona_14-Area_38-Sottoarea_79",2014,2,90,16,106
"2631","Zona_14-Area_38-Sottoarea_79",2014,3,77,15,92
"2632","Zona_14-Area_38-Sottoarea_79",2014,4,88,19,107
"2633","Zona_14-Area_38-Sottoarea_79",2014,5,85,17,102
"2634","Zona_14-Area_38-Sottoarea_79",2014,6,78,15,93
"2635","Zona_14-Area_38-Sottoarea_79",2014,7,86,19,105
"2636","Zona_14-Area_38-Sottoarea_79",2014,8,52,8,60
"2637","Zona_14-Area_38-Sottoarea_79",2014,9,89,12,101
"2638","Zona_14-Area_38-Sottoarea_79",2014,10,112,18,130
"2639","Zona_14-Area_38-Sottoarea_79",2014,11,83,17,100
"2640","Zona_14-Area_38-Sottoarea_79",2014,12,70,15,85
"2641","Zona_14-Area_38-Sottoarea_79",2015,1,93,12,105
"2642","Zona_14-Area_38-Sottoarea_79",2015,2,80,18,98
"2643","Zona_14-Area_38-Sottoarea_79",2015,3,82,20,102
"2644","Zona_14-Area_38-Sottoarea_79",2015,4,79,21,100
"2645","Zona_14-Area_38-Sottoarea_79",2015,5,67,41,108
"2646","Zona_14-Area_38-Sottoarea_79",2015,6,73,17,90
"2647","Zona_14-Area_38-Sottoarea_79",2015,7,77,15,92
"2648","Zona_14-Area_38-Sottoarea_79",2015,8,40,5,45
"2649","Zona_14-Area_38-Sottoarea_79",2015,9,71,11,82
"2650","Zona_14-Area_38-Sottoarea_79",2015,10,79,19,98
"2651","Zona_14-Area_38-Sottoarea_79",2015,11,75,12,87
"2652","Zona_14-Area_38-Sottoarea_79",2015,12,63,11,74
"2653","Zona_14-Area_38-Sottoarea_79",2016,1,63,12,75
"2654","Zona_14-Area_38-Sottoarea_79",2016,2,67,12,79
"2655","Zona_14-Area_38-Sottoarea_79",2016,3,70,15,85
"2656","Zona_14-Area_38-Sottoarea_79",2016,4,66,13,79
"2657","Zona_14-Area_38-Sottoarea_79",2016,5,52,9,61
"2658","Zona_14-Area_38-Sottoarea_79",2016,6,0,0,0
"2659","Zona_14-Area_38-Sottoarea_79",2016,7,0,0,0
"2660","Zona_14-Area_38-Sottoarea_79",2016,8,0,0,0
"2661","Zona_14-Area_38-Sottoarea_79",2016,9,0,0,0
"2662","Zona_14-Area_38-Sottoarea_79",2016,10,0,0,0
"2663","Zona_14-Area_38-Sottoarea_79",2016,11,0,0,0
"2664","Zona_14-Area_38-Sottoarea_79",2016,12,0,0,0
"2665","Zona_15-Area_39-Sottoarea_85",2014,1,50,35,85
"2666","Zona_15-Area_39-Sottoarea_85",2014,2,52,39,91
"2667","Zona_15-Area_39-Sottoarea_85",2014,3,46,29,75
"2668","Zona_15-Area_39-Sottoarea_85",2014,4,51,32,83
"2669","Zona_15-Area_39-Sottoarea_85",2014,5,48,26,74
"2670","Zona_15-Area_39-Sottoarea_85",2014,6,68,32,100
"2671","Zona_15-Area_39-Sottoarea_85",2014,7,60,33,93
"2672","Zona_15-Area_39-Sottoarea_85",2014,8,36,29,65
"2673","Zona_15-Area_39-Sottoarea_85",2014,9,77,24,101
"2674","Zona_15-Area_39-Sottoarea_85",2014,10,87,39,126
"2675","Zona_15-Area_39-Sottoarea_85",2014,11,84,35,119
"2676","Zona_15-Area_39-Sottoarea_85",2014,12,68,34,102
"2677","Zona_15-Area_39-Sottoarea_85",2015,1,62,27,89
"2678","Zona_15-Area_39-Sottoarea_85",2015,2,62,40,102
"2679","Zona_15-Area_39-Sottoarea_85",2015,3,84,37,121
"2680","Zona_15-Area_39-Sottoarea_85",2015,4,65,30,95
"2681","Zona_15-Area_39-Sottoarea_85",2015,5,64,36,100
"2682","Zona_15-Area_39-Sottoarea_85",2015,6,73,27,100
"2683","Zona_15-Area_39-Sottoarea_85",2015,7,64,26,90
"2684","Zona_15-Area_39-Sottoarea_85",2015,8,51,22,73
"2685","Zona_15-Area_39-Sottoarea_85",2015,9,71,29,100
"2686","Zona_15-Area_39-Sottoarea_85",2015,10,81,36,117
"2687","Zona_15-Area_39-Sottoarea_85",2015,11,74,28,102
"2688","Zona_15-Area_39-Sottoarea_85",2015,12,61,26,87
"2689","Zona_15-Area_39-Sottoarea_85",2016,1,65,21,86
"2690","Zona_15-Area_39-Sottoarea_85",2016,2,67,32,99
"2691","Zona_15-Area_39-Sottoarea_85",2016,3,70,42,112
"2692","Zona_15-Area_39-Sottoarea_85",2016,4,63,55,118
"2693","Zona_15-Area_39-Sottoarea_85",2016,5,36,26,62
"2694","Zona_15-Area_39-Sottoarea_85",2016,6,0,0,0
"2695","Zona_15-Area_39-Sottoarea_85",2016,7,0,0,0
"2696","Zona_15-Area_39-Sottoarea_85",2016,8,0,0,0
"2697","Zona_15-Area_39-Sottoarea_85",2016,9,0,0,0
"2698","Zona_15-Area_39-Sottoarea_85",2016,10,0,0,0
"2699","Zona_15-Area_39-Sottoarea_85",2016,11,0,0,0
"2700","Zona_15-Area_39-Sottoarea_85",2016,12,0,0,0
"2701","Zona_15-Area_39-Sottoarea_86",2014,1,152,98,250
"2702","Zona_15-Area_39-Sottoarea_86",2014,2,158,89,247
"2703","Zona_15-Area_39-Sottoarea_86",2014,3,150,90,240
"2704","Zona_15-Area_39-Sottoarea_86",2014,4,137,85,222
"2705","Zona_15-Area_39-Sottoarea_86",2014,5,152,73,225
"2706","Zona_15-Area_39-Sottoarea_86",2014,6,246,108,354
"2707","Zona_15-Area_39-Sottoarea_86",2014,7,190,87,277
"2708","Zona_15-Area_39-Sottoarea_86",2014,8,115,69,184
"2709","Zona_15-Area_39-Sottoarea_86",2014,9,196,63,259
"2710","Zona_15-Area_39-Sottoarea_86",2014,10,248,112,360
"2711","Zona_15-Area_39-Sottoarea_86",2014,11,242,103,345
"2712","Zona_15-Area_39-Sottoarea_86",2014,12,209,93,302
"2713","Zona_15-Area_39-Sottoarea_86",2015,1,192,90,282
"2714","Zona_15-Area_39-Sottoarea_86",2015,2,183,106,289
"2715","Zona_15-Area_39-Sottoarea_86",2015,3,212,122,334
"2716","Zona_15-Area_39-Sottoarea_86",2015,4,185,109,294
"2717","Zona_15-Area_39-Sottoarea_86",2015,5,179,126,305
"2718","Zona_15-Area_39-Sottoarea_86",2015,6,210,100,310
"2719","Zona_15-Area_39-Sottoarea_86",2015,7,203,88,291
"2720","Zona_15-Area_39-Sottoarea_86",2015,8,141,59,200
"2721","Zona_15-Area_39-Sottoarea_86",2015,9,209,83,292
"2722","Zona_15-Area_39-Sottoarea_86",2015,10,205,95,300
"2723","Zona_15-Area_39-Sottoarea_86",2015,11,215,94,309
"2724","Zona_15-Area_39-Sottoarea_86",2015,12,174,79,253
"2725","Zona_15-Area_39-Sottoarea_86",2016,1,184,71,255
"2726","Zona_15-Area_39-Sottoarea_86",2016,2,191,94,285
"2727","Zona_15-Area_39-Sottoarea_86",2016,3,213,114,327
"2728","Zona_15-Area_39-Sottoarea_86",2016,4,171,119,290
"2729","Zona_15-Area_39-Sottoarea_86",2016,5,108,74,182
"2730","Zona_15-Area_39-Sottoarea_86",2016,6,0,0,0
"2731","Zona_15-Area_39-Sottoarea_86",2016,7,0,0,0
"2732","Zona_15-Area_39-Sottoarea_86",2016,8,0,0,0
"2733","Zona_15-Area_39-Sottoarea_86",2016,9,0,0,0
"2734","Zona_15-Area_39-Sottoarea_86",2016,10,0,0,0
"2735","Zona_15-Area_39-Sottoarea_86",2016,11,0,0,0
"2736","Zona_15-Area_39-Sottoarea_86",2016,12,0,0,0
"2737","Zona_15-Area_39-Sottoarea_87",2014,1,75,45,120
"2738","Zona_15-Area_39-Sottoarea_87",2014,2,80,39,119
"2739","Zona_15-Area_39-Sottoarea_87",2014,3,64,37,101
"2740","Zona_15-Area_39-Sottoarea_87",2014,4,63,37,100
"2741","Zona_15-Area_39-Sottoarea_87",2014,5,60,32,92
"2742","Zona_15-Area_39-Sottoarea_87",2014,6,126,49,175
"2743","Zona_15-Area_39-Sottoarea_87",2014,7,94,43,137
"2744","Zona_15-Area_39-Sottoarea_87",2014,8,54,26,80
"2745","Zona_15-Area_39-Sottoarea_87",2014,9,97,29,126
"2746","Zona_15-Area_39-Sottoarea_87",2014,10,125,50,175
"2747","Zona_15-Area_39-Sottoarea_87",2014,11,133,31,164
"2748","Zona_15-Area_39-Sottoarea_87",2014,12,96,40,136
"2749","Zona_15-Area_39-Sottoarea_87",2015,1,85,41,126
"2750","Zona_15-Area_39-Sottoarea_87",2015,2,86,47,133
"2751","Zona_15-Area_39-Sottoarea_87",2015,3,94,49,143
"2752","Zona_15-Area_39-Sottoarea_87",2015,4,82,39,121
"2753","Zona_15-Area_39-Sottoarea_87",2015,5,90,43,133
"2754","Zona_15-Area_39-Sottoarea_87",2015,6,103,37,140
"2755","Zona_15-Area_39-Sottoarea_87",2015,7,87,34,121
"2756","Zona_15-Area_39-Sottoarea_87",2015,8,53,25,78
"2757","Zona_15-Area_39-Sottoarea_87",2015,9,98,30,128
"2758","Zona_15-Area_39-Sottoarea_87",2015,10,100,46,146
"2759","Zona_15-Area_39-Sottoarea_87",2015,11,102,41,143
"2760","Zona_15-Area_39-Sottoarea_87",2015,12,75,33,108
"2761","Zona_15-Area_39-Sottoarea_87",2016,1,76,25,101
"2762","Zona_15-Area_39-Sottoarea_87",2016,2,84,38,122
"2763","Zona_15-Area_39-Sottoarea_87",2016,3,93,43,136
"2764","Zona_15-Area_39-Sottoarea_87",2016,4,81,37,118
"2765","Zona_15-Area_39-Sottoarea_87",2016,5,41,33,74
"2766","Zona_15-Area_39-Sottoarea_87",2016,6,0,0,0
"2767","Zona_15-Area_39-Sottoarea_87",2016,7,0,0,0
"2768","Zona_15-Area_39-Sottoarea_87",2016,8,0,0,0
"2769","Zona_15-Area_39-Sottoarea_87",2016,9,0,0,0
"2770","Zona_15-Area_39-Sottoarea_87",2016,10,0,0,0
"2771","Zona_15-Area_39-Sottoarea_87",2016,11,0,0,0
"2772","Zona_15-Area_39-Sottoarea_87",2016,12,0,0,0
"2773","Zona_15-Area_40-Sottoarea_88",2014,1,271,201,472
"2774","Zona_15-Area_40-Sottoarea_88",2014,2,276,208,484
"2775","Zona_15-Area_40-Sottoarea_88",2014,3,223,199,422
"2776","Zona_15-Area_40-Sottoarea_88",2014,4,231,187,418
"2777","Zona_15-Area_40-Sottoarea_88",2014,5,207,153,360
"2778","Zona_15-Area_40-Sottoarea_88",2014,6,363,234,597
"2779","Zona_15-Area_40-Sottoarea_88",2014,7,276,202,478
"2780","Zona_15-Area_40-Sottoarea_88",2014,8,178,140,318
"2781","Zona_15-Area_40-Sottoarea_88",2014,9,293,131,424
"2782","Zona_15-Area_40-Sottoarea_88",2014,10,316,234,550
"2783","Zona_15-Area_40-Sottoarea_88",2014,11,302,196,498
"2784","Zona_15-Area_40-Sottoarea_88",2014,12,269,175,444
"2785","Zona_15-Area_40-Sottoarea_88",2015,1,294,159,453
"2786","Zona_15-Area_40-Sottoarea_88",2015,2,306,226,532
"2787","Zona_15-Area_40-Sottoarea_88",2015,3,334,252,586
"2788","Zona_15-Area_40-Sottoarea_88",2015,4,302,208,510
"2789","Zona_15-Area_40-Sottoarea_88",2015,5,288,221,509
"2790","Zona_15-Area_40-Sottoarea_88",2015,6,320,173,493
"2791","Zona_15-Area_40-Sottoarea_88",2015,7,356,175,531
"2792","Zona_15-Area_40-Sottoarea_88",2015,8,261,122,383
"2793","Zona_15-Area_40-Sottoarea_88",2015,9,382,169,551
"2794","Zona_15-Area_40-Sottoarea_88",2015,10,360,216,576
"2795","Zona_15-Area_40-Sottoarea_88",2015,11,355,179,534
"2796","Zona_15-Area_40-Sottoarea_88",2015,12,294,169,463
"2797","Zona_15-Area_40-Sottoarea_88",2016,1,326,157,483
"2798","Zona_15-Area_40-Sottoarea_88",2016,2,363,204,567
"2799","Zona_15-Area_40-Sottoarea_88",2016,3,408,239,647
"2800","Zona_15-Area_40-Sottoarea_88",2016,4,358,225,583
"2801","Zona_15-Area_40-Sottoarea_88",2016,5,210,134,344
"2802","Zona_15-Area_40-Sottoarea_88",2016,6,0,0,0
"2803","Zona_15-Area_40-Sottoarea_88",2016,7,0,0,0
"2804","Zona_15-Area_40-Sottoarea_88",2016,8,0,0,0
"2805","Zona_15-Area_40-Sottoarea_88",2016,9,0,0,0
"2806","Zona_15-Area_40-Sottoarea_88",2016,10,0,0,0
"2807","Zona_15-Area_40-Sottoarea_88",2016,11,0,0,0
"2808","Zona_15-Area_40-Sottoarea_88",2016,12,0,0,0
"2809","Zona_15-Area_41-Sottoarea_89",2014,1,65,52,117
"2810","Zona_15-Area_41-Sottoarea_89",2014,2,60,48,108
"2811","Zona_15-Area_41-Sottoarea_89",2014,3,50,46,96
"2812","Zona_15-Area_41-Sottoarea_89",2014,4,49,45,94
"2813","Zona_15-Area_41-Sottoarea_89",2014,5,44,39,83
"2814","Zona_15-Area_41-Sottoarea_89",2014,6,67,60,127
"2815","Zona_15-Area_41-Sottoarea_89",2014,7,58,53,111
"2816","Zona_15-Area_41-Sottoarea_89",2014,8,36,37,73
"2817","Zona_15-Area_41-Sottoarea_89",2014,9,65,32,97
"2818","Zona_15-Area_41-Sottoarea_89",2014,10,70,56,126
"2819","Zona_15-Area_41-Sottoarea_89",2014,11,81,50,131
"2820","Zona_15-Area_41-Sottoarea_89",2014,12,69,45,114
"2821","Zona_15-Area_41-Sottoarea_89",2015,1,75,44,119
"2822","Zona_15-Area_41-Sottoarea_89",2015,2,67,57,124
"2823","Zona_15-Area_41-Sottoarea_89",2015,3,82,51,133
"2824","Zona_15-Area_41-Sottoarea_89",2015,4,74,53,127
"2825","Zona_15-Area_41-Sottoarea_89",2015,5,74,55,129
"2826","Zona_15-Area_41-Sottoarea_89",2015,6,78,40,118
"2827","Zona_15-Area_41-Sottoarea_89",2015,7,82,41,123
"2828","Zona_15-Area_41-Sottoarea_89",2015,8,52,25,77
"2829","Zona_15-Area_41-Sottoarea_89",2015,9,85,36,121
"2830","Zona_15-Area_41-Sottoarea_89",2015,10,89,50,139
"2831","Zona_15-Area_41-Sottoarea_89",2015,11,89,48,137
"2832","Zona_15-Area_41-Sottoarea_89",2015,12,70,40,110
"2833","Zona_15-Area_41-Sottoarea_89",2016,1,78,41,119
"2834","Zona_15-Area_41-Sottoarea_89",2016,2,85,50,135
"2835","Zona_15-Area_41-Sottoarea_89",2016,3,88,58,146
"2836","Zona_15-Area_41-Sottoarea_89",2016,4,83,62,145
"2837","Zona_15-Area_41-Sottoarea_89",2016,5,46,31,77
"2838","Zona_15-Area_41-Sottoarea_89",2016,6,0,0,0
"2839","Zona_15-Area_41-Sottoarea_89",2016,7,0,0,0
"2840","Zona_15-Area_41-Sottoarea_89",2016,8,0,0,0
"2841","Zona_15-Area_41-Sottoarea_89",2016,9,0,0,0
"2842","Zona_15-Area_41-Sottoarea_89",2016,10,0,0,0
"2843","Zona_15-Area_41-Sottoarea_89",2016,11,0,0,0
"2844","Zona_15-Area_41-Sottoarea_89",2016,12,0,0,0
"2845","Zona_15-Area_41-Sottoarea_90",2014,1,229,164,393
"2846","Zona_15-Area_41-Sottoarea_90",2014,2,221,147,368
"2847","Zona_15-Area_41-Sottoarea_90",2014,3,169,133,302
"2848","Zona_15-Area_41-Sottoarea_90",2014,4,191,154,345
"2849","Zona_15-Area_41-Sottoarea_90",2014,5,188,135,323
"2850","Zona_15-Area_41-Sottoarea_90",2014,6,206,148,354
"2851","Zona_15-Area_41-Sottoarea_90",2014,7,210,151,361
"2852","Zona_15-Area_41-Sottoarea_90",2014,8,131,105,236
"2853","Zona_15-Area_41-Sottoarea_90",2014,9,221,111,332
"2854","Zona_15-Area_41-Sottoarea_90",2014,10,234,179,413
"2855","Zona_15-Area_41-Sottoarea_90",2014,11,218,161,379
"2856","Zona_15-Area_41-Sottoarea_90",2014,12,187,133,320
"2857","Zona_15-Area_41-Sottoarea_90",2015,1,238,134,372
"2858","Zona_15-Area_41-Sottoarea_90",2015,2,249,169,418
"2859","Zona_15-Area_41-Sottoarea_90",2015,3,272,199,471
"2860","Zona_15-Area_41-Sottoarea_90",2015,4,237,167,404
"2861","Zona_15-Area_41-Sottoarea_90",2015,5,214,182,396
"2862","Zona_15-Area_41-Sottoarea_90",2015,6,265,141,406
"2863","Zona_15-Area_41-Sottoarea_90",2015,7,253,144,397
"2864","Zona_15-Area_41-Sottoarea_90",2015,8,188,91,279
"2865","Zona_15-Area_41-Sottoarea_90",2015,9,277,124,401
"2866","Zona_15-Area_41-Sottoarea_90",2015,10,306,167,473
"2867","Zona_15-Area_41-Sottoarea_90",2015,11,304,155,459
"2868","Zona_15-Area_41-Sottoarea_90",2015,12,252,133,385
"2869","Zona_15-Area_41-Sottoarea_90",2016,1,282,122,404
"2870","Zona_15-Area_41-Sottoarea_90",2016,2,352,159,511
"2871","Zona_15-Area_41-Sottoarea_90",2016,3,384,195,579
"2872","Zona_15-Area_41-Sottoarea_90",2016,4,364,166,530
"2873","Zona_15-Area_41-Sottoarea_90",2016,5,203,113,316
"2874","Zona_15-Area_41-Sottoarea_90",2016,6,0,0,0
"2875","Zona_15-Area_41-Sottoarea_90",2016,7,0,0,0
"2876","Zona_15-Area_41-Sottoarea_90",2016,8,0,0,0
"2877","Zona_15-Area_41-Sottoarea_90",2016,9,0,0,0
"2878","Zona_15-Area_41-Sottoarea_90",2016,10,0,0,0
"2879","Zona_15-Area_41-Sottoarea_90",2016,11,0,0,0
"2880","Zona_15-Area_41-Sottoarea_90",2016,12,0,0,0
"2881","Zona_16-Area_42-Sottoarea_3",2014,1,33,4,37
"2882","Zona_16-Area_42-Sottoarea_3",2014,2,32,11,43
"2883","Zona_16-Area_42-Sottoarea_3",2014,3,23,11,34
"2884","Zona_16-Area_42-Sottoarea_3",2014,4,26,9,35
"2885","Zona_16-Area_42-Sottoarea_3",2014,5,27,7,34
"2886","Zona_16-Area_42-Sottoarea_3",2014,6,28,11,39
"2887","Zona_16-Area_42-Sottoarea_3",2014,7,22,5,27
"2888","Zona_16-Area_42-Sottoarea_3",2014,8,21,5,26
"2889","Zona_16-Area_42-Sottoarea_3",2014,9,33,7,40
"2890","Zona_16-Area_42-Sottoarea_3",2014,10,36,12,48
"2891","Zona_16-Area_42-Sottoarea_3",2014,11,29,10,39
"2892","Zona_16-Area_42-Sottoarea_3",2014,12,29,15,44
"2893","Zona_16-Area_42-Sottoarea_3",2015,1,35,6,41
"2894","Zona_16-Area_42-Sottoarea_3",2015,2,29,13,42
"2895","Zona_16-Area_42-Sottoarea_3",2015,3,33,15,48
"2896","Zona_16-Area_42-Sottoarea_3",2015,4,27,19,46
"2897","Zona_16-Area_42-Sottoarea_3",2015,5,33,13,46
"2898","Zona_16-Area_42-Sottoarea_3",2015,6,36,12,48
"2899","Zona_16-Area_42-Sottoarea_3",2015,7,26,10,36
"2900","Zona_16-Area_42-Sottoarea_3",2015,8,23,3,26
"2901","Zona_16-Area_42-Sottoarea_3",2015,9,35,8,43
"2902","Zona_16-Area_42-Sottoarea_3",2015,10,37,12,49
"2903","Zona_16-Area_42-Sottoarea_3",2015,11,36,12,48
"2904","Zona_16-Area_42-Sottoarea_3",2015,12,40,10,50
"2905","Zona_16-Area_42-Sottoarea_3",2016,1,36,10,46
"2906","Zona_16-Area_42-Sottoarea_3",2016,2,41,11,52
"2907","Zona_16-Area_42-Sottoarea_3",2016,3,41,14,55
"2908","Zona_16-Area_42-Sottoarea_3",2016,4,37,11,48
"2909","Zona_16-Area_42-Sottoarea_3",2016,5,24,7,31
"2910","Zona_16-Area_42-Sottoarea_3",2016,6,0,0,0
"2911","Zona_16-Area_42-Sottoarea_3",2016,7,0,0,0
"2912","Zona_16-Area_42-Sottoarea_3",2016,8,0,0,0
"2913","Zona_16-Area_42-Sottoarea_3",2016,9,0,0,0
"2914","Zona_16-Area_42-Sottoarea_3",2016,10,0,0,0
"2915","Zona_16-Area_42-Sottoarea_3",2016,11,0,0,0
"2916","Zona_16-Area_42-Sottoarea_3",2016,12,0,0,0
"2917","Zona_16-Area_42-Sottoarea_4",2014,1,96,36,132
"2918","Zona_16-Area_42-Sottoarea_4",2014,2,85,37,122
"2919","Zona_16-Area_42-Sottoarea_4",2014,3,75,35,110
"2920","Zona_16-Area_42-Sottoarea_4",2014,4,84,34,118
"2921","Zona_16-Area_42-Sottoarea_4",2014,5,89,37,126
"2922","Zona_16-Area_42-Sottoarea_4",2014,6,84,32,116
"2923","Zona_16-Area_42-Sottoarea_4",2014,7,89,32,121
"2924","Zona_16-Area_42-Sottoarea_4",2014,8,65,30,95
"2925","Zona_16-Area_42-Sottoarea_4",2014,9,97,29,126
"2926","Zona_16-Area_42-Sottoarea_4",2014,10,116,56,172
"2927","Zona_16-Area_42-Sottoarea_4",2014,11,103,49,152
"2928","Zona_16-Area_42-Sottoarea_4",2014,12,91,41,132
"2929","Zona_16-Area_42-Sottoarea_4",2015,1,107,31,138
"2930","Zona_16-Area_42-Sottoarea_4",2015,2,123,51,174
"2931","Zona_16-Area_42-Sottoarea_4",2015,3,113,50,163
"2932","Zona_16-Area_42-Sottoarea_4",2015,4,104,58,162
"2933","Zona_16-Area_42-Sottoarea_4",2015,5,114,61,175
"2934","Zona_16-Area_42-Sottoarea_4",2015,6,109,40,149
"2935","Zona_16-Area_42-Sottoarea_4",2015,7,111,44,155
"2936","Zona_16-Area_42-Sottoarea_4",2015,8,78,29,107
"2937","Zona_16-Area_42-Sottoarea_4",2015,9,111,38,149
"2938","Zona_16-Area_42-Sottoarea_4",2015,10,132,47,179
"2939","Zona_16-Area_42-Sottoarea_4",2015,11,128,46,174
"2940","Zona_16-Area_42-Sottoarea_4",2015,12,133,34,167
"2941","Zona_16-Area_42-Sottoarea_4",2016,1,138,31,169
"2942","Zona_16-Area_42-Sottoarea_4",2016,2,137,46,183
"2943","Zona_16-Area_42-Sottoarea_4",2016,3,150,52,202
"2944","Zona_16-Area_42-Sottoarea_4",2016,4,146,52,198
"2945","Zona_16-Area_42-Sottoarea_4",2016,5,79,25,104
"2946","Zona_16-Area_42-Sottoarea_4",2016,6,0,0,0
"2947","Zona_16-Area_42-Sottoarea_4",2016,7,0,0,0
"2948","Zona_16-Area_42-Sottoarea_4",2016,8,0,0,0
"2949","Zona_16-Area_42-Sottoarea_4",2016,9,0,0,0
"2950","Zona_16-Area_42-Sottoarea_4",2016,10,0,0,0
"2951","Zona_16-Area_42-Sottoarea_4",2016,11,0,0,0
"2952","Zona_16-Area_42-Sottoarea_4",2016,12,0,0,0
"2953","Zona_16-Area_43-Sottoarea_47",2014,1,90,30,120
"2954","Zona_16-Area_43-Sottoarea_47",2014,2,86,37,123
"2955","Zona_16-Area_43-Sottoarea_47",2014,3,66,27,93
"2956","Zona_16-Area_43-Sottoarea_47",2014,4,80,34,114
"2957","Zona_16-Area_43-Sottoarea_47",2014,5,80,30,110
"2958","Zona_16-Area_43-Sottoarea_47",2014,6,67,25,92
"2959","Zona_16-Area_43-Sottoarea_47",2014,7,76,30,106
"2960","Zona_16-Area_43-Sottoarea_47",2014,8,56,26,82
"2961","Zona_16-Area_43-Sottoarea_47",2014,9,81,22,103
"2962","Zona_16-Area_43-Sottoarea_47",2014,10,105,57,162
"2963","Zona_16-Area_43-Sottoarea_47",2014,11,87,38,125
"2964","Zona_16-Area_43-Sottoarea_47",2014,12,77,37,114
"2965","Zona_16-Area_43-Sottoarea_47",2015,1,104,30,134
"2966","Zona_16-Area_43-Sottoarea_47",2015,2,103,41,144
"2967","Zona_16-Area_43-Sottoarea_47",2015,3,101,54,155
"2968","Zona_16-Area_43-Sottoarea_47",2015,4,89,46,135
"2969","Zona_16-Area_43-Sottoarea_47",2015,5,89,53,142
"2970","Zona_16-Area_43-Sottoarea_47",2015,6,86,36,122
"2971","Zona_16-Area_43-Sottoarea_47",2015,7,90,33,123
"2972","Zona_16-Area_43-Sottoarea_47",2015,8,62,22,84
"2973","Zona_16-Area_43-Sottoarea_47",2015,9,96,31,127
"2974","Zona_16-Area_43-Sottoarea_47",2015,10,110,35,145
"2975","Zona_16-Area_43-Sottoarea_47",2015,11,90,35,125
"2976","Zona_16-Area_43-Sottoarea_47",2015,12,98,32,130
"2977","Zona_16-Area_43-Sottoarea_47",2016,1,89,33,122
"2978","Zona_16-Area_43-Sottoarea_47",2016,2,96,35,131
"2979","Zona_16-Area_43-Sottoarea_47",2016,3,104,44,148
"2980","Zona_16-Area_43-Sottoarea_47",2016,4,94,30,124
"2981","Zona_16-Area_43-Sottoarea_47",2016,5,60,16,76
"2982","Zona_16-Area_43-Sottoarea_47",2016,6,0,0,0
"2983","Zona_16-Area_43-Sottoarea_47",2016,7,0,0,0
"2984","Zona_16-Area_43-Sottoarea_47",2016,8,0,0,0
"2985","Zona_16-Area_43-Sottoarea_47",2016,9,0,0,0
"2986","Zona_16-Area_43-Sottoarea_47",2016,10,0,0,0
"2987","Zona_16-Area_43-Sottoarea_47",2016,11,0,0,0
"2988","Zona_16-Area_43-Sottoarea_47",2016,12,0,0,0
"2989","Zona_16-Area_43-Sottoarea_48",2014,1,38,9,47
"2990","Zona_16-Area_43-Sottoarea_48",2014,2,33,14,47
"2991","Zona_16-Area_43-Sottoarea_48",2014,3,27,11,38
"2992","Zona_16-Area_43-Sottoarea_48",2014,4,32,11,43
"2993","Zona_16-Area_43-Sottoarea_48",2014,5,33,10,43
"2994","Zona_16-Area_43-Sottoarea_48",2014,6,29,7,36
"2995","Zona_16-Area_43-Sottoarea_48",2014,7,30,9,39
"2996","Zona_16-Area_43-Sottoarea_48",2014,8,27,6,33
"2997","Zona_16-Area_43-Sottoarea_48",2014,9,34,10,44
"2998","Zona_16-Area_43-Sottoarea_48",2014,10,45,29,74
"2999","Zona_16-Area_43-Sottoarea_48",2014,11,43,13,56
"3000","Zona_16-Area_43-Sottoarea_48",2014,12,38,12,50
"3001","Zona_16-Area_43-Sottoarea_48",2015,1,43,11,54
"3002","Zona_16-Area_43-Sottoarea_48",2015,2,35,15,50
"3003","Zona_16-Area_43-Sottoarea_48",2015,3,47,20,67
"3004","Zona_16-Area_43-Sottoarea_48",2015,4,43,30,73
"3005","Zona_16-Area_43-Sottoarea_48",2015,5,33,34,67
"3006","Zona_16-Area_43-Sottoarea_48",2015,6,41,15,56
"3007","Zona_16-Area_43-Sottoarea_48",2015,7,37,12,49
"3008","Zona_16-Area_43-Sottoarea_48",2015,8,29,9,38
"3009","Zona_16-Area_43-Sottoarea_48",2015,9,40,9,49
"3010","Zona_16-Area_43-Sottoarea_48",2015,10,49,15,64
"3011","Zona_16-Area_43-Sottoarea_48",2015,11,40,21,61
"3012","Zona_16-Area_43-Sottoarea_48",2015,12,42,9,51
"3013","Zona_16-Area_43-Sottoarea_48",2016,1,42,12,54
"3014","Zona_16-Area_43-Sottoarea_48",2016,2,43,14,57
"3015","Zona_16-Area_43-Sottoarea_48",2016,3,51,19,70
"3016","Zona_16-Area_43-Sottoarea_48",2016,4,37,15,52
"3017","Zona_16-Area_43-Sottoarea_48",2016,5,29,5,34
"3018","Zona_16-Area_43-Sottoarea_48",2016,6,0,0,0
"3019","Zona_16-Area_43-Sottoarea_48",2016,7,0,0,0
"3020","Zona_16-Area_43-Sottoarea_48",2016,8,0,0,0
"3021","Zona_16-Area_43-Sottoarea_48",2016,9,0,0,0
"3022","Zona_16-Area_43-Sottoarea_48",2016,10,0,0,0
"3023","Zona_16-Area_43-Sottoarea_48",2016,11,0,0,0
"3024","Zona_16-Area_43-Sottoarea_48",2016,12,0,0,0
"3025","Zona_16-Area_43-Sottoarea_49",2014,1,41,18,59
"3026","Zona_16-Area_43-Sottoarea_49",2014,2,39,17,56
"3027","Zona_16-Area_43-Sottoarea_49",2014,3,33,12,45
"3028","Zona_16-Area_43-Sottoarea_49",2014,4,38,20,58
"3029","Zona_16-Area_43-Sottoarea_49",2014,5,36,15,51
"3030","Zona_16-Area_43-Sottoarea_49",2014,6,32,14,46
"3031","Zona_16-Area_43-Sottoarea_49",2014,7,36,12,48
"3032","Zona_16-Area_43-Sottoarea_49",2014,8,26,10,36
"3033","Zona_16-Area_43-Sottoarea_49",2014,9,40,15,55
"3034","Zona_16-Area_43-Sottoarea_49",2014,10,56,19,75
"3035","Zona_16-Area_43-Sottoarea_49",2014,11,45,22,67
"3036","Zona_16-Area_43-Sottoarea_49",2014,12,37,18,55
"3037","Zona_16-Area_43-Sottoarea_49",2015,1,48,14,62
"3038","Zona_16-Area_43-Sottoarea_49",2015,2,56,21,77
"3039","Zona_16-Area_43-Sottoarea_49",2015,3,53,25,78
"3040","Zona_16-Area_43-Sottoarea_49",2015,4,54,23,77
"3041","Zona_16-Area_43-Sottoarea_49",2015,5,53,20,73
"3042","Zona_16-Area_43-Sottoarea_49",2015,6,53,18,71
"3043","Zona_16-Area_43-Sottoarea_49",2015,7,101,30,131
"3044","Zona_16-Area_43-Sottoarea_49",2015,8,65,12,77
"3045","Zona_16-Area_43-Sottoarea_49",2015,9,88,15,103
"3046","Zona_16-Area_43-Sottoarea_49",2015,10,85,18,103
"3047","Zona_16-Area_43-Sottoarea_49",2015,11,70,16,86
"3048","Zona_16-Area_43-Sottoarea_49",2015,12,73,17,90
"3049","Zona_16-Area_43-Sottoarea_49",2016,1,59,17,76
"3050","Zona_16-Area_43-Sottoarea_49",2016,2,66,28,94
"3051","Zona_16-Area_43-Sottoarea_49",2016,3,73,28,101
"3052","Zona_16-Area_43-Sottoarea_49",2016,4,57,17,74
"3053","Zona_16-Area_43-Sottoarea_49",2016,5,31,10,41
"3054","Zona_16-Area_43-Sottoarea_49",2016,6,0,0,0
"3055","Zona_16-Area_43-Sottoarea_49",2016,7,0,0,0
"3056","Zona_16-Area_43-Sottoarea_49",2016,8,0,0,0
"3057","Zona_16-Area_43-Sottoarea_49",2016,9,0,0,0
"3058","Zona_16-Area_43-Sottoarea_49",2016,10,0,0,0
"3059","Zona_16-Area_43-Sottoarea_49",2016,11,0,0,0
"3060","Zona_16-Area_43-Sottoarea_49",2016,12,0,0,0
"3061","Zona_16-Area_44-Sottoarea_91",2014,1,170,63,233
"3062","Zona_16-Area_44-Sottoarea_91",2014,2,160,67,227
"3063","Zona_16-Area_44-Sottoarea_91",2014,3,123,54,177
"3064","Zona_16-Area_44-Sottoarea_91",2014,4,141,64,205
"3065","Zona_16-Area_44-Sottoarea_91",2014,5,150,60,210
"3066","Zona_16-Area_44-Sottoarea_91",2014,6,135,59,194
"3067","Zona_16-Area_44-Sottoarea_91",2014,7,133,61,194
"3068","Zona_16-Area_44-Sottoarea_91",2014,8,104,50,154
"3069","Zona_16-Area_44-Sottoarea_91",2014,9,175,65,240
"3070","Zona_16-Area_44-Sottoarea_91",2014,10,198,96,294
"3071","Zona_16-Area_44-Sottoarea_91",2014,11,160,92,252
"3072","Zona_16-Area_44-Sottoarea_91",2014,12,142,77,219
"3073","Zona_16-Area_44-Sottoarea_91",2015,1,170,58,228
"3074","Zona_16-Area_44-Sottoarea_91",2015,2,193,96,289
"3075","Zona_16-Area_44-Sottoarea_91",2015,3,205,151,356
"3076","Zona_16-Area_44-Sottoarea_91",2015,4,187,138,325
"3077","Zona_16-Area_44-Sottoarea_91",2015,5,193,95,288
"3078","Zona_16-Area_44-Sottoarea_91",2015,6,207,89,296
"3079","Zona_16-Area_44-Sottoarea_91",2015,7,208,87,295
"3080","Zona_16-Area_44-Sottoarea_91",2015,8,164,61,225
"3081","Zona_16-Area_44-Sottoarea_91",2015,9,223,71,294
"3082","Zona_16-Area_44-Sottoarea_91",2015,10,260,87,347
"3083","Zona_16-Area_44-Sottoarea_91",2015,11,209,62,271
"3084","Zona_16-Area_44-Sottoarea_91",2015,12,203,66,269
"3085","Zona_16-Area_44-Sottoarea_91",2016,1,185,68,253
"3086","Zona_16-Area_44-Sottoarea_91",2016,2,207,80,287
"3087","Zona_16-Area_44-Sottoarea_91",2016,3,215,91,306
"3088","Zona_16-Area_44-Sottoarea_91",2016,4,195,64,259
"3089","Zona_16-Area_44-Sottoarea_91",2016,5,115,46,161
"3090","Zona_16-Area_44-Sottoarea_91",2016,6,0,0,0
"3091","Zona_16-Area_44-Sottoarea_91",2016,7,0,0,0
"3092","Zona_16-Area_44-Sottoarea_91",2016,8,0,0,0
"3093","Zona_16-Area_44-Sottoarea_91",2016,9,0,0,0
"3094","Zona_16-Area_44-Sottoarea_91",2016,10,0,0,0
"3095","Zona_16-Area_44-Sottoarea_91",2016,11,0,0,0
"3096","Zona_16-Area_44-Sottoarea_91",2016,12,0,0,0
"3097","Zona_17-Area_45-Sottoarea_13",2014,1,181,151,332
"3098","Zona_17-Area_45-Sottoarea_13",2014,2,207,186,393
"3099","Zona_17-Area_45-Sottoarea_13",2014,3,195,115,310
"3100","Zona_17-Area_45-Sottoarea_13",2014,4,227,110,337
"3101","Zona_17-Area_45-Sottoarea_13",2014,5,208,89,297
"3102","Zona_17-Area_45-Sottoarea_13",2014,6,308,128,436
"3103","Zona_17-Area_45-Sottoarea_13",2014,7,270,115,385
"3104","Zona_17-Area_45-Sottoarea_13",2014,8,168,95,263
"3105","Zona_17-Area_45-Sottoarea_13",2014,9,234,85,319
"3106","Zona_17-Area_45-Sottoarea_13",2014,10,286,132,418
"3107","Zona_17-Area_45-Sottoarea_13",2014,11,258,112,370
"3108","Zona_17-Area_45-Sottoarea_13",2014,12,224,130,354
"3109","Zona_17-Area_45-Sottoarea_13",2015,1,201,127,328
"3110","Zona_17-Area_45-Sottoarea_13",2015,2,222,151,373
"3111","Zona_17-Area_45-Sottoarea_13",2015,3,235,167,402
"3112","Zona_17-Area_45-Sottoarea_13",2015,4,226,153,379
"3113","Zona_17-Area_45-Sottoarea_13",2015,5,216,150,366
"3114","Zona_17-Area_45-Sottoarea_13",2015,6,229,132,361
"3115","Zona_17-Area_45-Sottoarea_13",2015,7,239,141,380
"3116","Zona_17-Area_45-Sottoarea_13",2015,8,149,89,238
"3117","Zona_17-Area_45-Sottoarea_13",2015,9,253,114,367
"3118","Zona_17-Area_45-Sottoarea_13",2015,10,261,148,409
"3119","Zona_17-Area_45-Sottoarea_13",2015,11,223,126,349
"3120","Zona_17-Area_45-Sottoarea_13",2015,12,226,110,336
"3121","Zona_17-Area_45-Sottoarea_13",2016,1,207,139,346
"3122","Zona_17-Area_45-Sottoarea_13",2016,2,261,160,421
"3123","Zona_17-Area_45-Sottoarea_13",2016,3,279,175,454
"3124","Zona_17-Area_45-Sottoarea_13",2016,4,251,146,397
"3125","Zona_17-Area_45-Sottoarea_13",2016,5,159,86,245
"3126","Zona_17-Area_45-Sottoarea_13",2016,6,0,0,0
"3127","Zona_17-Area_45-Sottoarea_13",2016,7,0,0,0
"3128","Zona_17-Area_45-Sottoarea_13",2016,8,0,0,0
"3129","Zona_17-Area_45-Sottoarea_13",2016,9,0,0,0
"3130","Zona_17-Area_45-Sottoarea_13",2016,10,0,0,0
"3131","Zona_17-Area_45-Sottoarea_13",2016,11,0,0,0
"3132","Zona_17-Area_45-Sottoarea_13",2016,12,0,0,0
"3133","Zona_17-Area_45-Sottoarea_14",2014,1,55,42,97
"3134","Zona_17-Area_45-Sottoarea_14",2014,2,55,48,103
"3135","Zona_17-Area_45-Sottoarea_14",2014,3,41,37,78
"3136","Zona_17-Area_45-Sottoarea_14",2014,4,48,42,90
"3137","Zona_17-Area_45-Sottoarea_14",2014,5,35,38,73
"3138","Zona_17-Area_45-Sottoarea_14",2014,6,64,48,112
"3139","Zona_17-Area_45-Sottoarea_14",2014,7,50,46,96
"3140","Zona_17-Area_45-Sottoarea_14",2014,8,35,36,71
"3141","Zona_17-Area_45-Sottoarea_14",2014,9,45,42,87
"3142","Zona_17-Area_45-Sottoarea_14",2014,10,57,56,113
"3143","Zona_17-Area_45-Sottoarea_14",2014,11,50,57,107
"3144","Zona_17-Area_45-Sottoarea_14",2014,12,40,51,91
"3145","Zona_17-Area_45-Sottoarea_14",2015,1,47,37,84
"3146","Zona_17-Area_45-Sottoarea_14",2015,2,54,56,110
"3147","Zona_17-Area_45-Sottoarea_14",2015,3,47,61,108
"3148","Zona_17-Area_45-Sottoarea_14",2015,4,51,61,112
"3149","Zona_17-Area_45-Sottoarea_14",2015,5,40,49,89
"3150","Zona_17-Area_45-Sottoarea_14",2015,6,51,35,86
"3151","Zona_17-Area_45-Sottoarea_14",2015,7,57,45,102
"3152","Zona_17-Area_45-Sottoarea_14",2015,8,34,38,72
"3153","Zona_17-Area_45-Sottoarea_14",2015,9,51,39,90
"3154","Zona_17-Area_45-Sottoarea_14",2015,10,57,48,105
"3155","Zona_17-Area_45-Sottoarea_14",2015,11,49,43,92
"3156","Zona_17-Area_45-Sottoarea_14",2015,12,49,29,78
"3157","Zona_17-Area_45-Sottoarea_14",2016,1,46,44,90
"3158","Zona_17-Area_45-Sottoarea_14",2016,2,54,46,100
"3159","Zona_17-Area_45-Sottoarea_14",2016,3,68,45,113
"3160","Zona_17-Area_45-Sottoarea_14",2016,4,57,48,105
"3161","Zona_17-Area_45-Sottoarea_14",2016,5,33,24,57
"3162","Zona_17-Area_45-Sottoarea_14",2016,6,0,0,0
"3163","Zona_17-Area_45-Sottoarea_14",2016,7,0,0,0
"3164","Zona_17-Area_45-Sottoarea_14",2016,8,0,0,0
"3165","Zona_17-Area_45-Sottoarea_14",2016,9,0,0,0
"3166","Zona_17-Area_45-Sottoarea_14",2016,10,0,0,0
"3167","Zona_17-Area_45-Sottoarea_14",2016,11,0,0,0
"3168","Zona_17-Area_45-Sottoarea_14",2016,12,0,0,0
"3169","Zona_17-Area_46-Sottoarea_52",2014,1,126,70,196
"3170","Zona_17-Area_46-Sottoarea_52",2014,2,131,74,205
"3171","Zona_17-Area_46-Sottoarea_52",2014,3,98,61,159
"3172","Zona_17-Area_46-Sottoarea_52",2014,4,97,64,161
"3173","Zona_17-Area_46-Sottoarea_52",2014,5,95,58,153
"3174","Zona_17-Area_46-Sottoarea_52",2014,6,157,75,232
"3175","Zona_17-Area_46-Sottoarea_52",2014,7,113,71,184
"3176","Zona_17-Area_46-Sottoarea_52",2014,8,75,53,128
"3177","Zona_17-Area_46-Sottoarea_52",2014,9,109,49,158
"3178","Zona_17-Area_46-Sottoarea_52",2014,10,133,93,226
"3179","Zona_17-Area_46-Sottoarea_52",2014,11,109,76,185
"3180","Zona_17-Area_46-Sottoarea_52",2014,12,103,73,176
"3181","Zona_17-Area_46-Sottoarea_52",2015,1,123,86,209
"3182","Zona_17-Area_46-Sottoarea_52",2015,2,136,98,234
"3183","Zona_17-Area_46-Sottoarea_52",2015,3,131,119,250
"3184","Zona_17-Area_46-Sottoarea_52",2015,4,120,110,230
"3185","Zona_17-Area_46-Sottoarea_52",2015,5,113,95,208
"3186","Zona_17-Area_46-Sottoarea_52",2015,6,130,68,198
"3187","Zona_17-Area_46-Sottoarea_52",2015,7,129,73,202
"3188","Zona_17-Area_46-Sottoarea_52",2015,8,86,47,133
"3189","Zona_17-Area_46-Sottoarea_52",2015,9,135,54,189
"3190","Zona_17-Area_46-Sottoarea_52",2015,10,139,73,212
"3191","Zona_17-Area_46-Sottoarea_52",2015,11,134,82,216
"3192","Zona_17-Area_46-Sottoarea_52",2015,12,127,65,192
"3193","Zona_17-Area_46-Sottoarea_52",2016,1,142,58,200
"3194","Zona_17-Area_46-Sottoarea_52",2016,2,168,82,250
"3195","Zona_17-Area_46-Sottoarea_52",2016,3,187,87,274
"3196","Zona_17-Area_46-Sottoarea_52",2016,4,149,80,229
"3197","Zona_17-Area_46-Sottoarea_52",2016,5,92,43,135
"3198","Zona_17-Area_46-Sottoarea_52",2016,6,0,0,0
"3199","Zona_17-Area_46-Sottoarea_52",2016,7,0,0,0
"3200","Zona_17-Area_46-Sottoarea_52",2016,8,0,0,0
"3201","Zona_17-Area_46-Sottoarea_52",2016,9,0,0,0
"3202","Zona_17-Area_46-Sottoarea_52",2016,10,0,0,0
"3203","Zona_17-Area_46-Sottoarea_52",2016,11,0,0,0
"3204","Zona_17-Area_46-Sottoarea_52",2016,12,0,0,0
"3205","Zona_17-Area_46-Sottoarea_53",2014,1,125,80,205
"3206","Zona_17-Area_46-Sottoarea_53",2014,2,126,90,216
"3207","Zona_17-Area_46-Sottoarea_53",2014,3,95,83,178
"3208","Zona_17-Area_46-Sottoarea_53",2014,4,97,80,177
"3209","Zona_17-Area_46-Sottoarea_53",2014,5,84,67,151
"3210","Zona_17-Area_46-Sottoarea_53",2014,6,130,91,221
"3211","Zona_17-Area_46-Sottoarea_53",2014,7,110,84,194
"3212","Zona_17-Area_46-Sottoarea_53",2014,8,80,69,149
"3213","Zona_17-Area_46-Sottoarea_53",2014,9,112,59,171
"3214","Zona_17-Area_46-Sottoarea_53",2014,10,133,91,224
"3215","Zona_17-Area_46-Sottoarea_53",2014,11,105,85,190
"3216","Zona_17-Area_46-Sottoarea_53",2014,12,98,77,175
"3217","Zona_17-Area_46-Sottoarea_53",2015,1,109,70,179
"3218","Zona_17-Area_46-Sottoarea_53",2015,2,139,101,240
"3219","Zona_17-Area_46-Sottoarea_53",2015,3,125,96,221
"3220","Zona_17-Area_46-Sottoarea_53",2015,4,120,106,226
"3221","Zona_17-Area_46-Sottoarea_53",2015,5,107,101,208
"3222","Zona_17-Area_46-Sottoarea_53",2015,6,133,84,217
"3223","Zona_17-Area_46-Sottoarea_53",2015,7,128,97,225
"3224","Zona_17-Area_46-Sottoarea_53",2015,8,86,66,152
"3225","Zona_17-Area_46-Sottoarea_53",2015,9,132,68,200
"3226","Zona_17-Area_46-Sottoarea_53",2015,10,135,86,221
"3227","Zona_17-Area_46-Sottoarea_53",2015,11,112,86,198
"3228","Zona_17-Area_46-Sottoarea_53",2015,12,118,71,189
"3229","Zona_17-Area_46-Sottoarea_53",2016,1,117,80,197
"3230","Zona_17-Area_46-Sottoarea_53",2016,2,144,76,220
"3231","Zona_17-Area_46-Sottoarea_53",2016,3,171,90,261
"3232","Zona_17-Area_46-Sottoarea_53",2016,4,131,77,208
"3233","Zona_17-Area_46-Sottoarea_53",2016,5,88,48,136
"3234","Zona_17-Area_46-Sottoarea_53",2016,6,0,0,0
"3235","Zona_17-Area_46-Sottoarea_53",2016,7,0,0,0
"3236","Zona_17-Area_46-Sottoarea_53",2016,8,0,0,0
"3237","Zona_17-Area_46-Sottoarea_53",2016,9,0,0,0
"3238","Zona_17-Area_46-Sottoarea_53",2016,10,0,0,0
"3239","Zona_17-Area_46-Sottoarea_53",2016,11,0,0,0
"3240","Zona_17-Area_46-Sottoarea_53",2016,12,0,0,0
"3241","Zona_17-Area_47-Sottoarea_101",2014,1,80,54,134
"3242","Zona_17-Area_47-Sottoarea_101",2014,2,81,51,132
"3243","Zona_17-Area_47-Sottoarea_101",2014,3,55,45,100
"3244","Zona_17-Area_47-Sottoarea_101",2014,4,76,41,117
"3245","Zona_17-Area_47-Sottoarea_101",2014,5,67,40,107
"3246","Zona_17-Area_47-Sottoarea_101",2014,6,88,60,148
"3247","Zona_17-Area_47-Sottoarea_101",2014,7,79,49,128
"3248","Zona_17-Area_47-Sottoarea_101",2014,8,52,37,89
"3249","Zona_17-Area_47-Sottoarea_101",2014,9,76,31,107
"3250","Zona_17-Area_47-Sottoarea_101",2014,10,101,58,159
"3251","Zona_17-Area_47-Sottoarea_101",2014,11,92,52,144
"3252","Zona_17-Area_47-Sottoarea_101",2014,12,78,51,129
"3253","Zona_17-Area_47-Sottoarea_101",2015,1,73,44,117
"3254","Zona_17-Area_47-Sottoarea_101",2015,2,90,58,148
"3255","Zona_17-Area_47-Sottoarea_101",2015,3,87,92,179
"3256","Zona_17-Area_47-Sottoarea_101",2015,4,82,70,152
"3257","Zona_17-Area_47-Sottoarea_101",2015,5,72,63,135
"3258","Zona_17-Area_47-Sottoarea_101",2015,6,80,44,124
"3259","Zona_17-Area_47-Sottoarea_101",2015,7,83,55,138
"3260","Zona_17-Area_47-Sottoarea_101",2015,8,65,34,99
"3261","Zona_17-Area_47-Sottoarea_101",2015,9,88,48,136
"3262","Zona_17-Area_47-Sottoarea_101",2015,10,100,58,158
"3263","Zona_17-Area_47-Sottoarea_101",2015,11,94,73,167
"3264","Zona_17-Area_47-Sottoarea_101",2015,12,98,68,166
"3265","Zona_17-Area_47-Sottoarea_101",2016,1,88,46,134
"3266","Zona_17-Area_47-Sottoarea_101",2016,2,117,82,199
"3267","Zona_17-Area_47-Sottoarea_101",2016,3,130,121,251
"3268","Zona_17-Area_47-Sottoarea_101",2016,4,112,81,193
"3269","Zona_17-Area_47-Sottoarea_101",2016,5,67,44,111
"3270","Zona_17-Area_47-Sottoarea_101",2016,6,0,0,0
"3271","Zona_17-Area_47-Sottoarea_101",2016,7,0,0,0
"3272","Zona_17-Area_47-Sottoarea_101",2016,8,0,0,0
"3273","Zona_17-Area_47-Sottoarea_101",2016,9,0,0,0
"3274","Zona_17-Area_47-Sottoarea_101",2016,10,0,0,0
"3275","Zona_17-Area_47-Sottoarea_101",2016,11,0,0,0
"3276","Zona_17-Area_47-Sottoarea_101",2016,12,0,0,0
"3277","Zona_17-Area_47-Sottoarea_102",2014,1,145,76,221
"3278","Zona_17-Area_47-Sottoarea_102",2014,2,138,94,232
"3279","Zona_17-Area_47-Sottoarea_102",2014,3,100,75,175
"3280","Zona_17-Area_47-Sottoarea_102",2014,4,133,72,205
"3281","Zona_17-Area_47-Sottoarea_102",2014,5,116,73,189
"3282","Zona_17-Area_47-Sottoarea_102",2014,6,153,105,258
"3283","Zona_17-Area_47-Sottoarea_102",2014,7,125,83,208
"3284","Zona_17-Area_47-Sottoarea_102",2014,8,89,52,141
"3285","Zona_17-Area_47-Sottoarea_102",2014,9,108,55,163
"3286","Zona_17-Area_47-Sottoarea_102",2014,10,169,91,260
"3287","Zona_17-Area_47-Sottoarea_102",2014,11,155,103,258
"3288","Zona_17-Area_47-Sottoarea_102",2014,12,124,77,201
"3289","Zona_17-Area_47-Sottoarea_102",2015,1,126,64,190
"3290","Zona_17-Area_47-Sottoarea_102",2015,2,159,100,259
"3291","Zona_17-Area_47-Sottoarea_102",2015,3,164,167,331
"3292","Zona_17-Area_47-Sottoarea_102",2015,4,149,102,251
"3293","Zona_17-Area_47-Sottoarea_102",2015,5,138,136,274
"3294","Zona_17-Area_47-Sottoarea_102",2015,6,177,80,257
"3295","Zona_17-Area_47-Sottoarea_102",2015,7,180,84,264
"3296","Zona_17-Area_47-Sottoarea_102",2015,8,113,60,173
"3297","Zona_17-Area_47-Sottoarea_102",2015,9,179,83,262
"3298","Zona_17-Area_47-Sottoarea_102",2015,10,188,115,303
"3299","Zona_17-Area_47-Sottoarea_102",2015,11,169,113,282
"3300","Zona_17-Area_47-Sottoarea_102",2015,12,175,106,281
"3301","Zona_17-Area_47-Sottoarea_102",2016,1,167,102,269
"3302","Zona_17-Area_47-Sottoarea_102",2016,2,193,110,303
"3303","Zona_17-Area_47-Sottoarea_102",2016,3,210,139,349
"3304","Zona_17-Area_47-Sottoarea_102",2016,4,186,111,297
"3305","Zona_17-Area_47-Sottoarea_102",2016,5,119,66,185
"3306","Zona_17-Area_47-Sottoarea_102",2016,6,0,0,0
"3307","Zona_17-Area_47-Sottoarea_102",2016,7,0,0,0
"3308","Zona_17-Area_47-Sottoarea_102",2016,8,0,0,0
"3309","Zona_17-Area_47-Sottoarea_102",2016,9,0,0,0
"3310","Zona_17-Area_47-Sottoarea_102",2016,10,0,0,0
"3311","Zona_17-Area_47-Sottoarea_102",2016,11,0,0,0
"3312","Zona_17-Area_47-Sottoarea_102",2016,12,0,0,0
"3313","Zona_18-Area_48-Sottoarea_108",2014,1,97,46,143
"3314","Zona_18-Area_48-Sottoarea_108",2014,2,96,47,143
"3315","Zona_18-Area_48-Sottoarea_108",2014,3,75,43,118
"3316","Zona_18-Area_48-Sottoarea_108",2014,4,119,44,163
"3317","Zona_18-Area_48-Sottoarea_108",2014,5,123,57,180
"3318","Zona_18-Area_48-Sottoarea_108",2014,6,140,56,196
"3319","Zona_18-Area_48-Sottoarea_108",2014,7,132,62,194
"3320","Zona_18-Area_48-Sottoarea_108",2014,8,69,40,109
"3321","Zona_18-Area_48-Sottoarea_108",2014,9,110,32,142
"3322","Zona_18-Area_48-Sottoarea_108",2014,10,144,47,191
"3323","Zona_18-Area_48-Sottoarea_108",2014,11,134,36,170
"3324","Zona_18-Area_48-Sottoarea_108",2014,12,129,33,162
"3325","Zona_18-Area_48-Sottoarea_108",2015,1,125,34,159
"3326","Zona_18-Area_48-Sottoarea_108",2015,2,130,41,171
"3327","Zona_18-Area_48-Sottoarea_108",2015,3,141,53,194
"3328","Zona_18-Area_48-Sottoarea_108",2015,4,135,42,177
"3329","Zona_18-Area_48-Sottoarea_108",2015,5,120,38,158
"3330","Zona_18-Area_48-Sottoarea_108",2015,6,112,50,162
"3331","Zona_18-Area_48-Sottoarea_108",2015,7,115,33,148
"3332","Zona_18-Area_48-Sottoarea_108",2015,8,67,19,86
"3333","Zona_18-Area_48-Sottoarea_108",2015,9,121,27,148
"3334","Zona_18-Area_48-Sottoarea_108",2015,10,133,33,166
"3335","Zona_18-Area_48-Sottoarea_108",2015,11,127,41,168
"3336","Zona_18-Area_48-Sottoarea_108",2015,12,118,48,166
"3337","Zona_18-Area_48-Sottoarea_108",2016,1,110,23,133
"3338","Zona_18-Area_48-Sottoarea_108",2016,2,117,35,152
"3339","Zona_18-Area_48-Sottoarea_108",2016,3,125,52,177
"3340","Zona_18-Area_48-Sottoarea_108",2016,4,121,67,188
"3341","Zona_18-Area_48-Sottoarea_108",2016,5,79,22,101
"3342","Zona_18-Area_48-Sottoarea_108",2016,6,0,0,0
"3343","Zona_18-Area_48-Sottoarea_108",2016,7,0,0,0
"3344","Zona_18-Area_48-Sottoarea_108",2016,8,0,0,0
"3345","Zona_18-Area_48-Sottoarea_108",2016,9,0,0,0
"3346","Zona_18-Area_48-Sottoarea_108",2016,10,0,0,0
"3347","Zona_18-Area_48-Sottoarea_108",2016,11,0,0,0
"3348","Zona_18-Area_48-Sottoarea_108",2016,12,0,0,0
"3349","Zona_18-Area_48-Sottoarea_109",2014,1,161,72,233
"3350","Zona_18-Area_48-Sottoarea_109",2014,2,148,83,231
"3351","Zona_18-Area_48-Sottoarea_109",2014,3,127,103,230
"3352","Zona_18-Area_48-Sottoarea_109",2014,4,218,104,322
"3353","Zona_18-Area_48-Sottoarea_109",2014,5,197,81,278
"3354","Zona_18-Area_48-Sottoarea_109",2014,6,204,72,276
"3355","Zona_18-Area_48-Sottoarea_109",2014,7,216,84,300
"3356","Zona_18-Area_48-Sottoarea_109",2014,8,114,69,183
"3357","Zona_18-Area_48-Sottoarea_109",2014,9,196,51,247
"3358","Zona_18-Area_48-Sottoarea_109",2014,10,244,74,318
"3359","Zona_18-Area_48-Sottoarea_109",2014,11,222,71,293
"3360","Zona_18-Area_48-Sottoarea_109",2014,12,206,69,275
"3361","Zona_18-Area_48-Sottoarea_109",2015,1,192,79,271
"3362","Zona_18-Area_48-Sottoarea_109",2015,2,196,88,284
"3363","Zona_18-Area_48-Sottoarea_109",2015,3,244,112,356
"3364","Zona_18-Area_48-Sottoarea_109",2015,4,225,96,321
"3365","Zona_18-Area_48-Sottoarea_109",2015,5,201,67,268
"3366","Zona_18-Area_48-Sottoarea_109",2015,6,192,59,251
"3367","Zona_18-Area_48-Sottoarea_109",2015,7,197,61,258
"3368","Zona_18-Area_48-Sottoarea_109",2015,8,120,49,169
"3369","Zona_18-Area_48-Sottoarea_109",2015,9,204,65,269
"3370","Zona_18-Area_48-Sottoarea_109",2015,10,215,76,291
"3371","Zona_18-Area_48-Sottoarea_109",2015,11,189,81,270
"3372","Zona_18-Area_48-Sottoarea_109",2015,12,177,95,272
"3373","Zona_18-Area_48-Sottoarea_109",2016,1,180,52,232
"3374","Zona_18-Area_48-Sottoarea_109",2016,2,197,81,278
"3375","Zona_18-Area_48-Sottoarea_109",2016,3,207,95,302
"3376","Zona_18-Area_48-Sottoarea_109",2016,4,175,90,265
"3377","Zona_18-Area_48-Sottoarea_109",2016,5,107,51,158
"3378","Zona_18-Area_48-Sottoarea_109",2016,6,0,0,0
"3379","Zona_18-Area_48-Sottoarea_109",2016,7,0,0,0
"3380","Zona_18-Area_48-Sottoarea_109",2016,8,0,0,0
"3381","Zona_18-Area_48-Sottoarea_109",2016,9,0,0,0
"3382","Zona_18-Area_48-Sottoarea_109",2016,10,0,0,0
"3383","Zona_18-Area_48-Sottoarea_109",2016,11,0,0,0
"3384","Zona_18-Area_48-Sottoarea_109",2016,12,0,0,0
"3385","Zona_18-Area_49-Sottoarea_110",2014,1,59,47,106
"3386","Zona_18-Area_49-Sottoarea_110",2014,2,59,48,107
"3387","Zona_18-Area_49-Sottoarea_110",2014,3,51,41,92
"3388","Zona_18-Area_49-Sottoarea_110",2014,4,58,41,99
"3389","Zona_18-Area_49-Sottoarea_110",2014,5,60,47,107
"3390","Zona_18-Area_49-Sottoarea_110",2014,6,68,47,115
"3391","Zona_18-Area_49-Sottoarea_110",2014,7,73,54,127
"3392","Zona_18-Area_49-Sottoarea_110",2014,8,47,49,96
"3393","Zona_18-Area_49-Sottoarea_110",2014,9,63,42,105
"3394","Zona_18-Area_49-Sottoarea_110",2014,10,88,62,150
"3395","Zona_18-Area_49-Sottoarea_110",2014,11,90,64,154
"3396","Zona_18-Area_49-Sottoarea_110",2014,12,85,48,133
"3397","Zona_18-Area_49-Sottoarea_110",2015,1,80,35,115
"3398","Zona_18-Area_49-Sottoarea_110",2015,2,90,50,140
"3399","Zona_18-Area_49-Sottoarea_110",2015,3,87,63,150
"3400","Zona_18-Area_49-Sottoarea_110",2015,4,87,69,156
"3401","Zona_18-Area_49-Sottoarea_110",2015,5,84,44,128
"3402","Zona_18-Area_49-Sottoarea_110",2015,6,90,49,139
"3403","Zona_18-Area_49-Sottoarea_110",2015,7,81,57,138
"3404","Zona_18-Area_49-Sottoarea_110",2015,8,45,24,69
"3405","Zona_18-Area_49-Sottoarea_110",2015,9,86,50,136
"3406","Zona_18-Area_49-Sottoarea_110",2015,10,91,48,139
"3407","Zona_18-Area_49-Sottoarea_110",2015,11,78,45,123
"3408","Zona_18-Area_49-Sottoarea_110",2015,12,79,47,126
"3409","Zona_18-Area_49-Sottoarea_110",2016,1,72,31,103
"3410","Zona_18-Area_49-Sottoarea_110",2016,2,82,39,121
"3411","Zona_18-Area_49-Sottoarea_110",2016,3,89,53,142
"3412","Zona_18-Area_49-Sottoarea_110",2016,4,79,39,118
"3413","Zona_18-Area_49-Sottoarea_110",2016,5,49,22,71
"3414","Zona_18-Area_49-Sottoarea_110",2016,6,0,0,0
"3415","Zona_18-Area_49-Sottoarea_110",2016,7,0,0,0
"3416","Zona_18-Area_49-Sottoarea_110",2016,8,0,0,0
"3417","Zona_18-Area_49-Sottoarea_110",2016,9,0,0,0
"3418","Zona_18-Area_49-Sottoarea_110",2016,10,0,0,0
"3419","Zona_18-Area_49-Sottoarea_110",2016,11,0,0,0
"3420","Zona_18-Area_49-Sottoarea_110",2016,12,0,0,0
"3421","Zona_18-Area_49-Sottoarea_111",2014,1,214,153,367
"3422","Zona_18-Area_49-Sottoarea_111",2014,2,234,155,389
"3423","Zona_18-Area_49-Sottoarea_111",2014,3,196,153,349
"3424","Zona_18-Area_49-Sottoarea_111",2014,4,257,176,433
"3425","Zona_18-Area_49-Sottoarea_111",2014,5,254,157,411
"3426","Zona_18-Area_49-Sottoarea_111",2014,6,233,159,392
"3427","Zona_18-Area_49-Sottoarea_111",2014,7,257,181,438
"3428","Zona_18-Area_49-Sottoarea_111",2014,8,170,134,304
"3429","Zona_18-Area_49-Sottoarea_111",2014,9,232,133,365
"3430","Zona_18-Area_49-Sottoarea_111",2014,10,290,184,474
"3431","Zona_18-Area_49-Sottoarea_111",2014,11,280,190,470
"3432","Zona_18-Area_49-Sottoarea_111",2014,12,267,181,448
"3433","Zona_18-Area_49-Sottoarea_111",2015,1,264,145,409
"3434","Zona_18-Area_49-Sottoarea_111",2015,2,296,194,490
"3435","Zona_18-Area_49-Sottoarea_111",2015,3,297,208,505
"3436","Zona_18-Area_49-Sottoarea_111",2015,4,282,209,491
"3437","Zona_18-Area_49-Sottoarea_111",2015,5,292,179,471
"3438","Zona_18-Area_49-Sottoarea_111",2015,6,260,162,422
"3439","Zona_18-Area_49-Sottoarea_111",2015,7,266,173,439
"3440","Zona_18-Area_49-Sottoarea_111",2015,8,173,97,270
"3441","Zona_18-Area_49-Sottoarea_111",2015,9,300,126,426
"3442","Zona_18-Area_49-Sottoarea_111",2015,10,309,166,475
"3443","Zona_18-Area_49-Sottoarea_111",2015,11,282,141,423
"3444","Zona_18-Area_49-Sottoarea_111",2015,12,265,130,395
"3445","Zona_18-Area_49-Sottoarea_111",2016,1,273,105,378
"3446","Zona_18-Area_49-Sottoarea_111",2016,2,310,155,465
"3447","Zona_18-Area_49-Sottoarea_111",2016,3,333,169,502
"3448","Zona_18-Area_49-Sottoarea_111",2016,4,282,206,488
"3449","Zona_18-Area_49-Sottoarea_111",2016,5,174,82,256
"3450","Zona_18-Area_49-Sottoarea_111",2016,6,0,0,0
"3451","Zona_18-Area_49-Sottoarea_111",2016,7,0,0,0
"3452","Zona_18-Area_49-Sottoarea_111",2016,8,0,0,0
"3453","Zona_18-Area_49-Sottoarea_111",2016,9,0,0,0
"3454","Zona_18-Area_49-Sottoarea_111",2016,10,0,0,0
"3455","Zona_18-Area_49-Sottoarea_111",2016,11,0,0,0
"3456","Zona_18-Area_49-Sottoarea_111",2016,12,0,0,0
"3457","Zona_18-Area_50-Sottoarea_112",2014,1,114,35,149
"3458","Zona_18-Area_50-Sottoarea_112",2014,2,108,38,146
"3459","Zona_18-Area_50-Sottoarea_112",2014,3,91,32,123
"3460","Zona_18-Area_50-Sottoarea_112",2014,4,135,34,169
"3461","Zona_18-Area_50-Sottoarea_112",2014,5,133,38,171
"3462","Zona_18-Area_50-Sottoarea_112",2014,6,124,30,154
"3463","Zona_18-Area_50-Sottoarea_112",2014,7,140,33,173
"3464","Zona_18-Area_50-Sottoarea_112",2014,8,73,25,98
"3465","Zona_18-Area_50-Sottoarea_112",2014,9,140,28,168
"3466","Zona_18-Area_50-Sottoarea_112",2014,10,170,39,209
"3467","Zona_18-Area_50-Sottoarea_112",2014,11,145,38,183
"3468","Zona_18-Area_50-Sottoarea_112",2014,12,124,32,156
"3469","Zona_18-Area_50-Sottoarea_112",2015,1,125,27,152
"3470","Zona_18-Area_50-Sottoarea_112",2015,2,142,44,186
"3471","Zona_18-Area_50-Sottoarea_112",2015,3,150,51,201
"3472","Zona_18-Area_50-Sottoarea_112",2015,4,137,46,183
"3473","Zona_18-Area_50-Sottoarea_112",2015,5,120,35,155
"3474","Zona_18-Area_50-Sottoarea_112",2015,6,116,47,163
"3475","Zona_18-Area_50-Sottoarea_112",2015,7,122,33,155
"3476","Zona_18-Area_50-Sottoarea_112",2015,8,74,22,96
"3477","Zona_18-Area_50-Sottoarea_112",2015,9,141,46,187
"3478","Zona_18-Area_50-Sottoarea_112",2015,10,160,45,205
"3479","Zona_18-Area_50-Sottoarea_112",2015,11,137,40,177
"3480","Zona_18-Area_50-Sottoarea_112",2015,12,116,30,146
"3481","Zona_18-Area_50-Sottoarea_112",2016,1,119,25,144
"3482","Zona_18-Area_50-Sottoarea_112",2016,2,118,37,155
"3483","Zona_18-Area_50-Sottoarea_112",2016,3,125,41,166
"3484","Zona_18-Area_50-Sottoarea_112",2016,4,135,59,194
"3485","Zona_18-Area_50-Sottoarea_112",2016,5,84,21,105
"3486","Zona_18-Area_50-Sottoarea_112",2016,6,0,0,0
"3487","Zona_18-Area_50-Sottoarea_112",2016,7,0,0,0
"3488","Zona_18-Area_50-Sottoarea_112",2016,8,0,0,0
"3489","Zona_18-Area_50-Sottoarea_112",2016,9,0,0,0
"3490","Zona_18-Area_50-Sottoarea_112",2016,10,0,0,0
"3491","Zona_18-Area_50-Sottoarea_112",2016,11,0,0,0
"3492","Zona_18-Area_50-Sottoarea_112",2016,12,0,0,0
"3493","Zona_18-Area_50-Sottoarea_113",2014,1,181,102,283
"3494","Zona_18-Area_50-Sottoarea_113",2014,2,187,116,303
"3495","Zona_18-Area_50-Sottoarea_113",2014,3,142,100,242
"3496","Zona_18-Area_50-Sottoarea_113",2014,4,214,110,324
"3497","Zona_18-Area_50-Sottoarea_113",2014,5,204,95,299
"3498","Zona_18-Area_50-Sottoarea_113",2014,6,219,88,307
"3499","Zona_18-Area_50-Sottoarea_113",2014,7,238,96,334
"3500","Zona_18-Area_50-Sottoarea_113",2014,8,126,76,202
"3501","Zona_18-Area_50-Sottoarea_113",2014,9,218,69,287
"3502","Zona_18-Area_50-Sottoarea_113",2014,10,277,123,400
"3503","Zona_18-Area_50-Sottoarea_113",2014,11,258,95,353
"3504","Zona_18-Area_50-Sottoarea_113",2014,12,223,107,330
"3505","Zona_18-Area_50-Sottoarea_113",2015,1,228,105,333
"3506","Zona_18-Area_50-Sottoarea_113",2015,2,236,149,385
"3507","Zona_18-Area_50-Sottoarea_113",2015,3,262,149,411
"3508","Zona_18-Area_50-Sottoarea_113",2015,4,241,152,393
"3509","Zona_18-Area_50-Sottoarea_113",2015,5,210,115,325
"3510","Zona_18-Area_50-Sottoarea_113",2015,6,203,109,312
"3511","Zona_18-Area_50-Sottoarea_113",2015,7,206,125,331
"3512","Zona_18-Area_50-Sottoarea_113",2015,8,128,68,196
"3513","Zona_18-Area_50-Sottoarea_113",2015,9,230,110,340
"3514","Zona_18-Area_50-Sottoarea_113",2015,10,267,148,415
"3515","Zona_18-Area_50-Sottoarea_113",2015,11,233,142,375
"3516","Zona_18-Area_50-Sottoarea_113",2015,12,208,120,328
"3517","Zona_18-Area_50-Sottoarea_113",2016,1,207,80,287
"3518","Zona_18-Area_50-Sottoarea_113",2016,2,243,123,366
"3519","Zona_18-Area_50-Sottoarea_113",2016,3,257,198,455
"3520","Zona_18-Area_50-Sottoarea_113",2016,4,217,171,388
"3521","Zona_18-Area_50-Sottoarea_113",2016,5,141,78,219
"3522","Zona_18-Area_50-Sottoarea_113",2016,6,0,0,0
"3523","Zona_18-Area_50-Sottoarea_113",2016,7,0,0,0
"3524","Zona_18-Area_50-Sottoarea_113",2016,8,0,0,0
"3525","Zona_18-Area_50-Sottoarea_113",2016,9,0,0,0
"3526","Zona_18-Area_50-Sottoarea_113",2016,10,0,0,0
"3527","Zona_18-Area_50-Sottoarea_113",2016,11,0,0,0
"3528","Zona_18-Area_50-Sottoarea_113",2016,12,0,0,0
"3529","Zona_18-Area_51-Sottoarea_114",2014,1,262,193,455
"3530","Zona_18-Area_51-Sottoarea_114",2014,2,271,189,460
"3531","Zona_18-Area_51-Sottoarea_114",2014,3,240,212,452
"3532","Zona_18-Area_51-Sottoarea_114",2014,4,287,216,503
"3533","Zona_18-Area_51-Sottoarea_114",2014,5,325,201,526
"3534","Zona_18-Area_51-Sottoarea_114",2014,6,298,191,489
"3535","Zona_18-Area_51-Sottoarea_114",2014,7,334,230,564
"3536","Zona_18-Area_51-Sottoarea_114",2014,8,228,172,400
"3537","Zona_18-Area_51-Sottoarea_114",2014,9,306,142,448
"3538","Zona_18-Area_51-Sottoarea_114",2014,10,370,192,562
"3539","Zona_18-Area_51-Sottoarea_114",2014,11,348,169,517
"3540","Zona_18-Area_51-Sottoarea_114",2014,12,320,150,470
"3541","Zona_18-Area_51-Sottoarea_114",2015,1,303,148,451
"3542","Zona_18-Area_51-Sottoarea_114",2015,2,320,191,511
"3543","Zona_18-Area_51-Sottoarea_114",2015,3,341,202,543
"3544","Zona_18-Area_51-Sottoarea_114",2015,4,340,225,565
"3545","Zona_18-Area_51-Sottoarea_114",2015,5,319,157,476
"3546","Zona_18-Area_51-Sottoarea_114",2015,6,314,153,467
"3547","Zona_18-Area_51-Sottoarea_114",2015,7,328,156,484
"3548","Zona_18-Area_51-Sottoarea_114",2015,8,190,108,298
"3549","Zona_18-Area_51-Sottoarea_114",2015,9,317,134,451
"3550","Zona_18-Area_51-Sottoarea_114",2015,10,346,179,525
"3551","Zona_18-Area_51-Sottoarea_114",2015,11,313,145,458
"3552","Zona_18-Area_51-Sottoarea_114",2015,12,291,143,434
"3553","Zona_18-Area_51-Sottoarea_114",2016,1,308,114,422
"3554","Zona_18-Area_51-Sottoarea_114",2016,2,313,169,482
"3555","Zona_18-Area_51-Sottoarea_114",2016,3,359,209,568
"3556","Zona_18-Area_51-Sottoarea_114",2016,4,329,170,499
"3557","Zona_18-Area_51-Sottoarea_114",2016,5,193,86,279
"3558","Zona_18-Area_51-Sottoarea_114",2016,6,0,0,0
"3559","Zona_18-Area_51-Sottoarea_114",2016,7,0,0,0
"3560","Zona_18-Area_51-Sottoarea_114",2016,8,0,0,0
"3561","Zona_18-Area_51-Sottoarea_114",2016,9,0,0,0
"3562","Zona_18-Area_51-Sottoarea_114",2016,10,0,0,0
"3563","Zona_18-Area_51-Sottoarea_114",2016,11,0,0,0
"3564","Zona_18-Area_51-Sottoarea_114",2016,12,0,0,0
"3565","Zona_18-Area_51-Sottoarea_115",2014,1,16,10,26
"3566","Zona_18-Area_51-Sottoarea_115",2014,2,21,7,28
"3567","Zona_18-Area_51-Sottoarea_115",2014,3,16,10,26
"3568","Zona_18-Area_51-Sottoarea_115",2014,4,19,8,27
"3569","Zona_18-Area_51-Sottoarea_115",2014,5,25,5,30
"3570","Zona_18-Area_51-Sottoarea_115",2014,6,31,7,38
"3571","Zona_18-Area_51-Sottoarea_115",2014,7,30,4,34
"3572","Zona_18-Area_51-Sottoarea_115",2014,8,15,4,19
"3573","Zona_18-Area_51-Sottoarea_115",2014,9,21,2,23
"3574","Zona_18-Area_51-Sottoarea_115",2014,10,23,6,29
"3575","Zona_18-Area_51-Sottoarea_115",2014,11,23,7,30
"3576","Zona_18-Area_51-Sottoarea_115",2014,12,19,19,38
"3577","Zona_18-Area_51-Sottoarea_115",2015,1,20,14,34
"3578","Zona_18-Area_51-Sottoarea_115",2015,2,19,22,41
"3579","Zona_18-Area_51-Sottoarea_115",2015,3,21,19,40
"3580","Zona_18-Area_51-Sottoarea_115",2015,4,18,20,38
"3581","Zona_18-Area_51-Sottoarea_115",2015,5,25,10,35
"3582","Zona_18-Area_51-Sottoarea_115",2015,6,20,16,36
"3583","Zona_18-Area_51-Sottoarea_115",2015,7,20,12,32
"3584","Zona_18-Area_51-Sottoarea_115",2015,8,10,3,13
"3585","Zona_18-Area_51-Sottoarea_115",2015,9,21,19,40
"3586","Zona_18-Area_51-Sottoarea_115",2015,10,22,20,42
"3587","Zona_18-Area_51-Sottoarea_115",2015,11,18,18,36
"3588","Zona_18-Area_51-Sottoarea_115",2015,12,16,16,32
"3589","Zona_18-Area_51-Sottoarea_115",2016,1,20,7,27
"3590","Zona_18-Area_51-Sottoarea_115",2016,2,18,7,25
"3591","Zona_18-Area_51-Sottoarea_115",2016,3,21,14,35
"3592","Zona_18-Area_51-Sottoarea_115",2016,4,19,6,25
"3593","Zona_18-Area_51-Sottoarea_115",2016,5,10,3,13
"3594","Zona_18-Area_51-Sottoarea_115",2016,6,0,0,0
"3595","Zona_18-Area_51-Sottoarea_115",2016,7,0,0,0
"3596","Zona_18-Area_51-Sottoarea_115",2016,8,0,0,0
"3597","Zona_18-Area_51-Sottoarea_115",2016,9,0,0,0
"3598","Zona_18-Area_51-Sottoarea_115",2016,10,0,0,0
"3599","Zona_18-Area_51-Sottoarea_115",2016,11,0,0,0
"3600","Zona_18-Area_51-Sottoarea_115",2016,12,0,0,0
"3601","Zona_19-Area_52-Sottoarea_116",2014,1,82,21,103
"3602","Zona_19-Area_52-Sottoarea_116",2014,2,90,31,121
"3603","Zona_19-Area_52-Sottoarea_116",2014,3,60,21,81
"3604","Zona_19-Area_52-Sottoarea_116",2014,4,90,25,115
"3605","Zona_19-Area_52-Sottoarea_116",2014,5,87,22,109
"3606","Zona_19-Area_52-Sottoarea_116",2014,6,83,27,110
"3607","Zona_19-Area_52-Sottoarea_116",2014,7,91,26,117
"3608","Zona_19-Area_52-Sottoarea_116",2014,8,59,20,79
"3609","Zona_19-Area_52-Sottoarea_116",2014,9,68,27,95
"3610","Zona_19-Area_52-Sottoarea_116",2014,10,89,31,120
"3611","Zona_19-Area_52-Sottoarea_116",2014,11,81,31,112
"3612","Zona_19-Area_52-Sottoarea_116",2014,12,82,34,116
"3613","Zona_19-Area_52-Sottoarea_116",2015,1,83,26,109
"3614","Zona_19-Area_52-Sottoarea_116",2015,2,94,26,120
"3615","Zona_19-Area_52-Sottoarea_116",2015,3,91,46,137
"3616","Zona_19-Area_52-Sottoarea_116",2015,4,82,39,121
"3617","Zona_19-Area_52-Sottoarea_116",2015,5,78,33,111
"3618","Zona_19-Area_52-Sottoarea_116",2015,6,83,27,110
"3619","Zona_19-Area_52-Sottoarea_116",2015,7,76,30,106
"3620","Zona_19-Area_52-Sottoarea_116",2015,8,59,20,79
"3621","Zona_19-Area_52-Sottoarea_116",2015,9,64,30,94
"3622","Zona_19-Area_52-Sottoarea_116",2015,10,81,32,113
"3623","Zona_19-Area_52-Sottoarea_116",2015,11,79,31,110
"3624","Zona_19-Area_52-Sottoarea_116",2015,12,77,25,102
"3625","Zona_19-Area_52-Sottoarea_116",2016,1,80,25,105
"3626","Zona_19-Area_52-Sottoarea_116",2016,2,96,29,125
"3627","Zona_19-Area_52-Sottoarea_116",2016,3,107,30,137
"3628","Zona_19-Area_52-Sottoarea_116",2016,4,88,28,116
"3629","Zona_19-Area_52-Sottoarea_116",2016,5,58,18,76
"3630","Zona_19-Area_52-Sottoarea_116",2016,6,0,0,0
"3631","Zona_19-Area_52-Sottoarea_116",2016,7,0,0,0
"3632","Zona_19-Area_52-Sottoarea_116",2016,8,0,0,0
"3633","Zona_19-Area_52-Sottoarea_116",2016,9,0,0,0
"3634","Zona_19-Area_52-Sottoarea_116",2016,10,0,0,0
"3635","Zona_19-Area_52-Sottoarea_116",2016,11,0,0,0
"3636","Zona_19-Area_52-Sottoarea_116",2016,12,0,0,0
"3637","Zona_19-Area_52-Sottoarea_117",2014,1,24,4,28
"3638","Zona_19-Area_52-Sottoarea_117",2014,2,26,7,33
"3639","Zona_19-Area_52-Sottoarea_117",2014,3,18,5,23
"3640","Zona_19-Area_52-Sottoarea_117",2014,4,24,7,31
"3641","Zona_19-Area_52-Sottoarea_117",2014,5,23,5,28
"3642","Zona_19-Area_52-Sottoarea_117",2014,6,23,1,24
"3643","Zona_19-Area_52-Sottoarea_117",2014,7,31,6,37
"3644","Zona_19-Area_52-Sottoarea_117",2014,8,21,2,23
"3645","Zona_19-Area_52-Sottoarea_117",2014,9,20,3,23
"3646","Zona_19-Area_52-Sottoarea_117",2014,10,26,9,35
"3647","Zona_19-Area_52-Sottoarea_117",2014,11,23,7,30
"3648","Zona_19-Area_52-Sottoarea_117",2014,12,26,10,36
"3649","Zona_19-Area_52-Sottoarea_117",2015,1,22,3,25
"3650","Zona_19-Area_52-Sottoarea_117",2015,2,27,8,35
"3651","Zona_19-Area_52-Sottoarea_117",2015,3,22,11,33
"3652","Zona_19-Area_52-Sottoarea_117",2015,4,22,11,33
"3653","Zona_19-Area_52-Sottoarea_117",2015,5,22,7,29
"3654","Zona_19-Area_52-Sottoarea_117",2015,6,22,9,31
"3655","Zona_19-Area_52-Sottoarea_117",2015,7,24,13,37
"3656","Zona_19-Area_52-Sottoarea_117",2015,8,20,7,27
"3657","Zona_19-Area_52-Sottoarea_117",2015,9,21,4,25
"3658","Zona_19-Area_52-Sottoarea_117",2015,10,23,6,29
"3659","Zona_19-Area_52-Sottoarea_117",2015,11,24,8,32
"3660","Zona_19-Area_52-Sottoarea_117",2015,12,23,5,28
"3661","Zona_19-Area_52-Sottoarea_117",2016,1,23,4,27
"3662","Zona_19-Area_52-Sottoarea_117",2016,2,32,5,37
"3663","Zona_19-Area_52-Sottoarea_117",2016,3,25,10,35
"3664","Zona_19-Area_52-Sottoarea_117",2016,4,20,9,29
"3665","Zona_19-Area_52-Sottoarea_117",2016,5,14,5,19
"3666","Zona_19-Area_52-Sottoarea_117",2016,6,0,0,0
"3667","Zona_19-Area_52-Sottoarea_117",2016,7,0,0,0
"3668","Zona_19-Area_52-Sottoarea_117",2016,8,0,0,0
"3669","Zona_19-Area_52-Sottoarea_117",2016,9,0,0,0
"3670","Zona_19-Area_52-Sottoarea_117",2016,10,0,0,0
"3671","Zona_19-Area_52-Sottoarea_117",2016,11,0,0,0
"3672","Zona_19-Area_52-Sottoarea_117",2016,12,0,0,0
"3673","Zona_19-Area_52-Sottoarea_118",2014,1,82,34,116
"3674","Zona_19-Area_52-Sottoarea_118",2014,2,80,35,115
"3675","Zona_19-Area_52-Sottoarea_118",2014,3,59,26,85
"3676","Zona_19-Area_52-Sottoarea_118",2014,4,79,33,112
"3677","Zona_19-Area_52-Sottoarea_118",2014,5,83,32,115
"3678","Zona_19-Area_52-Sottoarea_118",2014,6,76,32,108
"3679","Zona_19-Area_52-Sottoarea_118",2014,7,83,37,120
"3680","Zona_19-Area_52-Sottoarea_118",2014,8,62,26,88
"3681","Zona_19-Area_52-Sottoarea_118",2014,9,82,23,105
"3682","Zona_19-Area_52-Sottoarea_118",2014,10,93,39,132
"3683","Zona_19-Area_52-Sottoarea_118",2014,11,79,38,117
"3684","Zona_19-Area_52-Sottoarea_118",2014,12,82,31,113
"3685","Zona_19-Area_52-Sottoarea_118",2015,1,75,39,114
"3686","Zona_19-Area_52-Sottoarea_118",2015,2,94,44,138
"3687","Zona_19-Area_52-Sottoarea_118",2015,3,88,54,142
"3688","Zona_19-Area_52-Sottoarea_118",2015,4,72,49,121
"3689","Zona_19-Area_52-Sottoarea_118",2015,5,78,49,127
"3690","Zona_19-Area_52-Sottoarea_118",2015,6,90,37,127
"3691","Zona_19-Area_52-Sottoarea_118",2015,7,94,33,127
"3692","Zona_19-Area_52-Sottoarea_118",2015,8,70,26,96
"3693","Zona_19-Area_52-Sottoarea_118",2015,9,109,33,142
"3694","Zona_19-Area_52-Sottoarea_118",2015,10,124,46,170
"3695","Zona_19-Area_52-Sottoarea_118",2015,11,114,40,154
"3696","Zona_19-Area_52-Sottoarea_118",2015,12,96,28,124
"3697","Zona_19-Area_52-Sottoarea_118",2016,1,106,29,135
"3698","Zona_19-Area_52-Sottoarea_118",2016,2,110,37,147
"3699","Zona_19-Area_52-Sottoarea_118",2016,3,126,40,166
"3700","Zona_19-Area_52-Sottoarea_118",2016,4,105,39,144
"3701","Zona_19-Area_52-Sottoarea_118",2016,5,66,26,92
"3702","Zona_19-Area_52-Sottoarea_118",2016,6,0,0,0
"3703","Zona_19-Area_52-Sottoarea_118",2016,7,0,0,0
"3704","Zona_19-Area_52-Sottoarea_118",2016,8,0,0,0
"3705","Zona_19-Area_52-Sottoarea_118",2016,9,0,0,0
"3706","Zona_19-Area_52-Sottoarea_118",2016,10,0,0,0
"3707","Zona_19-Area_52-Sottoarea_118",2016,11,0,0,0
"3708","Zona_19-Area_52-Sottoarea_118",2016,12,0,0,0
"3709","Zona_19-Area_53-Sottoarea_119",2014,1,23,7,30
"3710","Zona_19-Area_53-Sottoarea_119",2014,2,23,9,32
"3711","Zona_19-Area_53-Sottoarea_119",2014,3,18,4,22
"3712","Zona_19-Area_53-Sottoarea_119",2014,4,23,10,33
"3713","Zona_19-Area_53-Sottoarea_119",2014,5,25,9,34
"3714","Zona_19-Area_53-Sottoarea_119",2014,6,24,10,34
"3715","Zona_19-Area_53-Sottoarea_119",2014,7,25,4,29
"3716","Zona_19-Area_53-Sottoarea_119",2014,8,22,4,26
"3717","Zona_19-Area_53-Sottoarea_119",2014,9,22,6,28
"3718","Zona_19-Area_53-Sottoarea_119",2014,10,26,5,31
"3719","Zona_19-Area_53-Sottoarea_119",2014,11,20,12,32
"3720","Zona_19-Area_53-Sottoarea_119",2014,12,22,8,30
"3721","Zona_19-Area_53-Sottoarea_119",2015,1,24,4,28
"3722","Zona_19-Area_53-Sottoarea_119",2015,2,25,8,33
"3723","Zona_19-Area_53-Sottoarea_119",2015,3,25,17,42
"3724","Zona_19-Area_53-Sottoarea_119",2015,4,22,15,37
"3725","Zona_19-Area_53-Sottoarea_119",2015,5,21,7,28
"3726","Zona_19-Area_53-Sottoarea_119",2015,6,19,6,25
"3727","Zona_19-Area_53-Sottoarea_119",2015,7,21,8,29
"3728","Zona_19-Area_53-Sottoarea_119",2015,8,13,2,15
"3729","Zona_19-Area_53-Sottoarea_119",2015,9,20,4,24
"3730","Zona_19-Area_53-Sottoarea_119",2015,10,23,9,32
"3731","Zona_19-Area_53-Sottoarea_119",2015,11,23,10,33
"3732","Zona_19-Area_53-Sottoarea_119",2015,12,24,5,29
"3733","Zona_19-Area_53-Sottoarea_119",2016,1,22,3,25
"3734","Zona_19-Area_53-Sottoarea_119",2016,2,27,7,34
"3735","Zona_19-Area_53-Sottoarea_119",2016,3,29,7,36
"3736","Zona_19-Area_53-Sottoarea_119",2016,4,24,7,31
"3737","Zona_19-Area_53-Sottoarea_119",2016,5,16,3,19
"3738","Zona_19-Area_53-Sottoarea_119",2016,6,0,0,0
"3739","Zona_19-Area_53-Sottoarea_119",2016,7,0,0,0
"3740","Zona_19-Area_53-Sottoarea_119",2016,8,0,0,0
"3741","Zona_19-Area_53-Sottoarea_119",2016,9,0,0,0
"3742","Zona_19-Area_53-Sottoarea_119",2016,10,0,0,0
"3743","Zona_19-Area_53-Sottoarea_119",2016,11,0,0,0
"3744","Zona_19-Area_53-Sottoarea_119",2016,12,0,0,0
"3745","Zona_19-Area_53-Sottoarea_120",2014,1,201,74,275
"3746","Zona_19-Area_53-Sottoarea_120",2014,2,212,90,302
"3747","Zona_19-Area_53-Sottoarea_120",2014,3,163,74,237
"3748","Zona_19-Area_53-Sottoarea_120",2014,4,200,87,287
"3749","Zona_19-Area_53-Sottoarea_120",2014,5,211,85,296
"3750","Zona_19-Area_53-Sottoarea_120",2014,6,198,75,273
"3751","Zona_19-Area_53-Sottoarea_120",2014,7,197,91,288
"3752","Zona_19-Area_53-Sottoarea_120",2014,8,154,64,218
"3753","Zona_19-Area_53-Sottoarea_120",2014,9,201,74,275
"3754","Zona_19-Area_53-Sottoarea_120",2014,10,236,101,337
"3755","Zona_19-Area_53-Sottoarea_120",2014,11,216,90,306
"3756","Zona_19-Area_53-Sottoarea_120",2014,12,199,85,284
"3757","Zona_19-Area_53-Sottoarea_120",2015,1,217,82,299
"3758","Zona_19-Area_53-Sottoarea_120",2015,2,237,94,331
"3759","Zona_19-Area_53-Sottoarea_120",2015,3,224,135,359
"3760","Zona_19-Area_53-Sottoarea_120",2015,4,210,117,327
"3761","Zona_19-Area_53-Sottoarea_120",2015,5,208,115,323
"3762","Zona_19-Area_53-Sottoarea_120",2015,6,198,88,286
"3763","Zona_19-Area_53-Sottoarea_120",2015,7,217,91,308
"3764","Zona_19-Area_53-Sottoarea_120",2015,8,155,76,231
"3765","Zona_19-Area_53-Sottoarea_120",2015,9,216,85,301
"3766","Zona_19-Area_53-Sottoarea_120",2015,10,251,112,363
"3767","Zona_19-Area_53-Sottoarea_120",2015,11,246,105,351
"3768","Zona_19-Area_53-Sottoarea_120",2015,12,226,96,322
"3769","Zona_19-Area_53-Sottoarea_120",2016,1,240,92,332
"3770","Zona_19-Area_53-Sottoarea_120",2016,2,248,117,365
"3771","Zona_19-Area_53-Sottoarea_120",2016,3,266,125,391
"3772","Zona_19-Area_53-Sottoarea_120",2016,4,238,110,348
"3773","Zona_19-Area_53-Sottoarea_120",2016,5,139,67,206
"3774","Zona_19-Area_53-Sottoarea_120",2016,6,0,0,0
"3775","Zona_19-Area_53-Sottoarea_120",2016,7,0,0,0
"3776","Zona_19-Area_53-Sottoarea_120",2016,8,0,0,0
"3777","Zona_19-Area_53-Sottoarea_120",2016,9,0,0,0
"3778","Zona_19-Area_53-Sottoarea_120",2016,10,0,0,0
"3779","Zona_19-Area_53-Sottoarea_120",2016,11,0,0,0
"3780","Zona_19-Area_53-Sottoarea_120",2016,12,0,0,0
"3781","Zona_20-Area_54-Sottoarea_41",2014,1,110,51,161
"3782","Zona_20-Area_54-Sottoarea_41",2014,2,115,54,169
"3783","Zona_20-Area_54-Sottoarea_41",2014,3,98,47,145
"3784","Zona_20-Area_54-Sottoarea_41",2014,4,112,50,162
"3785","Zona_20-Area_54-Sottoarea_41",2014,5,117,50,167
"3786","Zona_20-Area_54-Sottoarea_41",2014,6,167,95,262
"3787","Zona_20-Area_54-Sottoarea_41",2014,7,126,83,209
"3788","Zona_20-Area_54-Sottoarea_41",2014,8,91,81,172
"3789","Zona_20-Area_54-Sottoarea_41",2014,9,111,80,191
"3790","Zona_20-Area_54-Sottoarea_41",2014,10,124,86,210
"3791","Zona_20-Area_54-Sottoarea_41",2014,11,133,77,210
"3792","Zona_20-Area_54-Sottoarea_41",2014,12,125,74,199
"3793","Zona_20-Area_54-Sottoarea_41",2015,1,105,51,156
"3794","Zona_20-Area_54-Sottoarea_41",2015,2,104,62,166
"3795","Zona_20-Area_54-Sottoarea_41",2015,3,137,104,241
"3796","Zona_20-Area_54-Sottoarea_41",2015,4,120,70,190
"3797","Zona_20-Area_54-Sottoarea_41",2015,5,124,67,191
"3798","Zona_20-Area_54-Sottoarea_41",2015,6,136,53,189
"3799","Zona_20-Area_54-Sottoarea_41",2015,7,137,66,203
"3800","Zona_20-Area_54-Sottoarea_41",2015,8,100,39,139
"3801","Zona_20-Area_54-Sottoarea_41",2015,9,142,54,196
"3802","Zona_20-Area_54-Sottoarea_41",2015,10,157,68,225
"3803","Zona_20-Area_54-Sottoarea_41",2015,11,131,57,188
"3804","Zona_20-Area_54-Sottoarea_41",2015,12,125,57,182
"3805","Zona_20-Area_54-Sottoarea_41",2016,1,118,44,162
"3806","Zona_20-Area_54-Sottoarea_41",2016,2,125,67,192
"3807","Zona_20-Area_54-Sottoarea_41",2016,3,133,93,226
"3808","Zona_20-Area_54-Sottoarea_41",2016,4,127,62,189
"3809","Zona_20-Area_54-Sottoarea_41",2016,5,82,40,122
"3810","Zona_20-Area_54-Sottoarea_41",2016,6,0,0,0
"3811","Zona_20-Area_54-Sottoarea_41",2016,7,0,0,0
"3812","Zona_20-Area_54-Sottoarea_41",2016,8,0,0,0
"3813","Zona_20-Area_54-Sottoarea_41",2016,9,0,0,0
"3814","Zona_20-Area_54-Sottoarea_41",2016,10,0,0,0
"3815","Zona_20-Area_54-Sottoarea_41",2016,11,0,0,0
"3816","Zona_20-Area_54-Sottoarea_41",2016,12,0,0,0
"3817","Zona_20-Area_54-Sottoarea_42",2014,1,170,94,264
"3818","Zona_20-Area_54-Sottoarea_42",2014,2,197,99,296
"3819","Zona_20-Area_54-Sottoarea_42",2014,3,149,74,223
"3820","Zona_20-Area_54-Sottoarea_42",2014,4,176,85,261
"3821","Zona_20-Area_54-Sottoarea_42",2014,5,149,86,235
"3822","Zona_20-Area_54-Sottoarea_42",2014,6,228,130,358
"3823","Zona_20-Area_54-Sottoarea_42",2014,7,181,94,275
"3824","Zona_20-Area_54-Sottoarea_42",2014,8,120,72,192
"3825","Zona_20-Area_54-Sottoarea_42",2014,9,164,82,246
"3826","Zona_20-Area_54-Sottoarea_42",2014,10,176,109,285
"3827","Zona_20-Area_54-Sottoarea_42",2014,11,187,114,301
"3828","Zona_20-Area_54-Sottoarea_42",2014,12,182,90,272
"3829","Zona_20-Area_54-Sottoarea_42",2015,1,180,90,270
"3830","Zona_20-Area_54-Sottoarea_42",2015,2,183,98,281
"3831","Zona_20-Area_54-Sottoarea_42",2015,3,225,186,411
"3832","Zona_20-Area_54-Sottoarea_42",2015,4,189,116,305
"3833","Zona_20-Area_54-Sottoarea_42",2015,5,182,113,295
"3834","Zona_20-Area_54-Sottoarea_42",2015,6,206,98,304
"3835","Zona_20-Area_54-Sottoarea_42",2015,7,223,103,326
"3836","Zona_20-Area_54-Sottoarea_42",2015,8,158,71,229
"3837","Zona_20-Area_54-Sottoarea_42",2015,9,194,82,276
"3838","Zona_20-Area_54-Sottoarea_42",2015,10,225,108,333
"3839","Zona_20-Area_54-Sottoarea_42",2015,11,191,95,286
"3840","Zona_20-Area_54-Sottoarea_42",2015,12,195,87,282
"3841","Zona_20-Area_54-Sottoarea_42",2016,1,175,83,258
"3842","Zona_20-Area_54-Sottoarea_42",2016,2,203,109,312
"3843","Zona_20-Area_54-Sottoarea_42",2016,3,218,142,360
"3844","Zona_20-Area_54-Sottoarea_42",2016,4,203,102,305
"3845","Zona_20-Area_54-Sottoarea_42",2016,5,126,62,188
"3846","Zona_20-Area_54-Sottoarea_42",2016,6,0,0,0
"3847","Zona_20-Area_54-Sottoarea_42",2016,7,0,0,0
"3848","Zona_20-Area_54-Sottoarea_42",2016,8,0,0,0
"3849","Zona_20-Area_54-Sottoarea_42",2016,9,0,0,0
"3850","Zona_20-Area_54-Sottoarea_42",2016,10,0,0,0
"3851","Zona_20-Area_54-Sottoarea_42",2016,11,0,0,0
"3852","Zona_20-Area_54-Sottoarea_42",2016,12,0,0,0
"3853","Zona_20-Area_55-Sottoarea_68",2014,1,67,39,106
"3854","Zona_20-Area_55-Sottoarea_68",2014,2,63,41,104
"3855","Zona_20-Area_55-Sottoarea_68",2014,3,53,36,89
"3856","Zona_20-Area_55-Sottoarea_68",2014,4,59,34,93
"3857","Zona_20-Area_55-Sottoarea_68",2014,5,55,29,84
"3858","Zona_20-Area_55-Sottoarea_68",2014,6,82,51,133
"3859","Zona_20-Area_55-Sottoarea_68",2014,7,67,36,103
"3860","Zona_20-Area_55-Sottoarea_68",2014,8,44,29,73
"3861","Zona_20-Area_55-Sottoarea_68",2014,9,63,33,96
"3862","Zona_20-Area_55-Sottoarea_68",2014,10,72,50,122
"3863","Zona_20-Area_55-Sottoarea_68",2014,11,83,47,130
"3864","Zona_20-Area_55-Sottoarea_68",2014,12,75,40,115
"3865","Zona_20-Area_55-Sottoarea_68",2015,1,77,39,116
"3866","Zona_20-Area_55-Sottoarea_68",2015,2,78,40,118
"3867","Zona_20-Area_55-Sottoarea_68",2015,3,95,73,168
"3868","Zona_20-Area_55-Sottoarea_68",2015,4,87,57,144
"3869","Zona_20-Area_55-Sottoarea_68",2015,5,77,49,126
"3870","Zona_20-Area_55-Sottoarea_68",2015,6,93,45,138
"3871","Zona_20-Area_55-Sottoarea_68",2015,7,88,37,125
"3872","Zona_20-Area_55-Sottoarea_68",2015,8,64,37,101
"3873","Zona_20-Area_55-Sottoarea_68",2015,9,88,49,137
"3874","Zona_20-Area_55-Sottoarea_68",2015,10,97,50,147
"3875","Zona_20-Area_55-Sottoarea_68",2015,11,95,48,143
"3876","Zona_20-Area_55-Sottoarea_68",2015,12,85,44,129
"3877","Zona_20-Area_55-Sottoarea_68",2016,1,83,30,113
"3878","Zona_20-Area_55-Sottoarea_68",2016,2,96,50,146
"3879","Zona_20-Area_55-Sottoarea_68",2016,3,106,56,162
"3880","Zona_20-Area_55-Sottoarea_68",2016,4,100,43,143
"3881","Zona_20-Area_55-Sottoarea_68",2016,5,52,28,80
"3882","Zona_20-Area_55-Sottoarea_68",2016,6,0,0,0
"3883","Zona_20-Area_55-Sottoarea_68",2016,7,0,0,0
"3884","Zona_20-Area_55-Sottoarea_68",2016,8,0,0,0
"3885","Zona_20-Area_55-Sottoarea_68",2016,9,0,0,0
"3886","Zona_20-Area_55-Sottoarea_68",2016,10,0,0,0
"3887","Zona_20-Area_55-Sottoarea_68",2016,11,0,0,0
"3888","Zona_20-Area_55-Sottoarea_68",2016,12,0,0,0
"3889","Zona_20-Area_55-Sottoarea_69",2014,1,72,37,109
"3890","Zona_20-Area_55-Sottoarea_69",2014,2,74,40,114
"3891","Zona_20-Area_55-Sottoarea_69",2014,3,56,33,89
"3892","Zona_20-Area_55-Sottoarea_69",2014,4,69,38,107
"3893","Zona_20-Area_55-Sottoarea_69",2014,5,62,33,95
"3894","Zona_20-Area_55-Sottoarea_69",2014,6,92,47,139
"3895","Zona_20-Area_55-Sottoarea_69",2014,7,81,35,116
"3896","Zona_20-Area_55-Sottoarea_69",2014,8,57,27,84
"3897","Zona_20-Area_55-Sottoarea_69",2014,9,82,24,106
"3898","Zona_20-Area_55-Sottoarea_69",2014,10,93,38,131
"3899","Zona_20-Area_55-Sottoarea_69",2014,11,104,44,148
"3900","Zona_20-Area_55-Sottoarea_69",2014,12,100,35,135
"3901","Zona_20-Area_55-Sottoarea_69",2015,1,85,30,115
"3902","Zona_20-Area_55-Sottoarea_69",2015,2,91,38,129
"3903","Zona_20-Area_55-Sottoarea_69",2015,3,116,57,173
"3904","Zona_20-Area_55-Sottoarea_69",2015,4,101,44,145
"3905","Zona_20-Area_55-Sottoarea_69",2015,5,87,44,131
"3906","Zona_20-Area_55-Sottoarea_69",2015,6,109,46,155
"3907","Zona_20-Area_55-Sottoarea_69",2015,7,92,32,124
"3908","Zona_20-Area_55-Sottoarea_69",2015,8,71,30,101
"3909","Zona_20-Area_55-Sottoarea_69",2015,9,88,39,127
"3910","Zona_20-Area_55-Sottoarea_69",2015,10,102,47,149
"3911","Zona_20-Area_55-Sottoarea_69",2015,11,89,43,132
"3912","Zona_20-Area_55-Sottoarea_69",2015,12,88,32,120
"3913","Zona_20-Area_55-Sottoarea_69",2016,1,89,35,124
"3914","Zona_20-Area_55-Sottoarea_69",2016,2,102,49,151
"3915","Zona_20-Area_55-Sottoarea_69",2016,3,114,59,173
"3916","Zona_20-Area_55-Sottoarea_69",2016,4,100,45,145
"3917","Zona_20-Area_55-Sottoarea_69",2016,5,60,26,86
"3918","Zona_20-Area_55-Sottoarea_69",2016,6,0,0,0
"3919","Zona_20-Area_55-Sottoarea_69",2016,7,0,0,0
"3920","Zona_20-Area_55-Sottoarea_69",2016,8,0,0,0
"3921","Zona_20-Area_55-Sottoarea_69",2016,9,0,0,0
"3922","Zona_20-Area_55-Sottoarea_69",2016,10,0,0,0
"3923","Zona_20-Area_55-Sottoarea_69",2016,11,0,0,0
"3924","Zona_20-Area_55-Sottoarea_69",2016,12,0,0,0
"3925","Zona_20-Area_56-Sottoarea_103",2014,1,105,51,156
"3926","Zona_20-Area_56-Sottoarea_103",2014,2,99,55,154
"3927","Zona_20-Area_56-Sottoarea_103",2014,3,80,45,125
"3928","Zona_20-Area_56-Sottoarea_103",2014,4,84,45,129
"3929","Zona_20-Area_56-Sottoarea_103",2014,5,79,38,117
"3930","Zona_20-Area_56-Sottoarea_103",2014,6,106,64,170
"3931","Zona_20-Area_56-Sottoarea_103",2014,7,86,53,139
"3932","Zona_20-Area_56-Sottoarea_103",2014,8,60,38,98
"3933","Zona_20-Area_56-Sottoarea_103",2014,9,73,33,106
"3934","Zona_20-Area_56-Sottoarea_103",2014,10,90,57,147
"3935","Zona_20-Area_56-Sottoarea_103",2014,11,103,61,164
"3936","Zona_20-Area_56-Sottoarea_103",2014,12,84,55,139
"3937","Zona_20-Area_56-Sottoarea_103",2015,1,86,48,134
"3938","Zona_20-Area_56-Sottoarea_103",2015,2,93,66,159
"3939","Zona_20-Area_56-Sottoarea_103",2015,3,99,90,189
"3940","Zona_20-Area_56-Sottoarea_103",2015,4,84,67,151
"3941","Zona_20-Area_56-Sottoarea_103",2015,5,85,67,152
"3942","Zona_20-Area_56-Sottoarea_103",2015,6,94,54,148
"3943","Zona_20-Area_56-Sottoarea_103",2015,7,81,52,133
"3944","Zona_20-Area_56-Sottoarea_103",2015,8,68,43,111
"3945","Zona_20-Area_56-Sottoarea_103",2015,9,85,43,128
"3946","Zona_20-Area_56-Sottoarea_103",2015,10,103,61,164
"3947","Zona_20-Area_56-Sottoarea_103",2015,11,92,49,141
"3948","Zona_20-Area_56-Sottoarea_103",2015,12,96,48,144
"3949","Zona_20-Area_56-Sottoarea_103",2016,1,89,40,129
"3950","Zona_20-Area_56-Sottoarea_103",2016,2,92,54,146
"3951","Zona_20-Area_56-Sottoarea_103",2016,3,113,69,182
"3952","Zona_20-Area_56-Sottoarea_103",2016,4,96,56,152
"3953","Zona_20-Area_56-Sottoarea_103",2016,5,54,37,91
"3954","Zona_20-Area_56-Sottoarea_103",2016,6,0,0,0
"3955","Zona_20-Area_56-Sottoarea_103",2016,7,0,0,0
"3956","Zona_20-Area_56-Sottoarea_103",2016,8,0,0,0
"3957","Zona_20-Area_56-Sottoarea_103",2016,9,0,0,0
"3958","Zona_20-Area_56-Sottoarea_103",2016,10,0,0,0
"3959","Zona_20-Area_56-Sottoarea_103",2016,11,0,0,0
"3960","Zona_20-Area_56-Sottoarea_103",2016,12,0,0,0
"3961","Zona_20-Area_56-Sottoarea_104",2014,1,88,42,130
"3962","Zona_20-Area_56-Sottoarea_104",2014,2,89,49,138
"3963","Zona_20-Area_56-Sottoarea_104",2014,3,75,37,112
"3964","Zona_20-Area_56-Sottoarea_104",2014,4,75,39,114
"3965","Zona_20-Area_56-Sottoarea_104",2014,5,81,37,118
"3966","Zona_20-Area_56-Sottoarea_104",2014,6,108,62,170
"3967","Zona_20-Area_56-Sottoarea_104",2014,7,85,43,128
"3968","Zona_20-Area_56-Sottoarea_104",2014,8,63,38,101
"3969","Zona_20-Area_56-Sottoarea_104",2014,9,78,35,113
"3970","Zona_20-Area_56-Sottoarea_104",2014,10,86,53,139
"3971","Zona_20-Area_56-Sottoarea_104",2014,11,108,52,160
"3972","Zona_20-Area_56-Sottoarea_104",2014,12,96,49,145
"3973","Zona_20-Area_56-Sottoarea_104",2015,1,102,45,147
"3974","Zona_20-Area_56-Sottoarea_104",2015,2,104,58,162
"3975","Zona_20-Area_56-Sottoarea_104",2015,3,119,96,215
"3976","Zona_20-Area_56-Sottoarea_104",2015,4,100,62,162
"3977","Zona_20-Area_56-Sottoarea_104",2015,5,88,58,146
"3978","Zona_20-Area_56-Sottoarea_104",2015,6,99,46,145
"3979","Zona_20-Area_56-Sottoarea_104",2015,7,95,48,143
"3980","Zona_20-Area_56-Sottoarea_104",2015,8,75,37,112
"3981","Zona_20-Area_56-Sottoarea_104",2015,9,105,47,152
"3982","Zona_20-Area_56-Sottoarea_104",2015,10,108,58,166
"3983","Zona_20-Area_56-Sottoarea_104",2015,11,105,55,160
"3984","Zona_20-Area_56-Sottoarea_104",2015,12,96,48,144
"3985","Zona_20-Area_56-Sottoarea_104",2016,1,102,39,141
"3986","Zona_20-Area_56-Sottoarea_104",2016,2,118,54,172
"3987","Zona_20-Area_56-Sottoarea_104",2016,3,122,59,181
"3988","Zona_20-Area_56-Sottoarea_104",2016,4,120,57,177
"3989","Zona_20-Area_56-Sottoarea_104",2016,5,62,34,96
"3990","Zona_20-Area_56-Sottoarea_104",2016,6,0,0,0
"3991","Zona_20-Area_56-Sottoarea_104",2016,7,0,0,0
"3992","Zona_20-Area_56-Sottoarea_104",2016,8,0,0,0
"3993","Zona_20-Area_56-Sottoarea_104",2016,9,0,0,0
"3994","Zona_20-Area_56-Sottoarea_104",2016,10,0,0,0
"3995","Zona_20-Area_56-Sottoarea_104",2016,11,0,0,0
"3996","Zona_20-Area_56-Sottoarea_104",2016,12,0,0,0
"3997","Zona_21-Area_57-Sottoarea_1",2014,1,65,40,105
"3998","Zona_21-Area_57-Sottoarea_1",2014,2,61,37,98
"3999","Zona_21-Area_57-Sottoarea_1",2014,3,54,28,82
"4000","Zona_21-Area_57-Sottoarea_1",2014,4,63,34,97
"4001","Zona_21-Area_57-Sottoarea_1",2014,5,53,34,87
"4002","Zona_21-Area_57-Sottoarea_1",2014,6,62,34,96
"4003","Zona_21-Area_57-Sottoarea_1",2014,7,56,43,99
"4004","Zona_21-Area_57-Sottoarea_1",2014,8,47,32,79
"4005","Zona_21-Area_57-Sottoarea_1",2014,9,66,31,97
"4006","Zona_21-Area_57-Sottoarea_1",2014,10,72,51,123
"4007","Zona_21-Area_57-Sottoarea_1",2014,11,61,48,109
"4008","Zona_21-Area_57-Sottoarea_1",2014,12,57,44,101
"4009","Zona_21-Area_57-Sottoarea_1",2015,1,62,39,101
"4010","Zona_21-Area_57-Sottoarea_1",2015,2,71,47,118
"4011","Zona_21-Area_57-Sottoarea_1",2015,3,76,91,167
"4012","Zona_21-Area_57-Sottoarea_1",2015,4,66,52,118
"4013","Zona_21-Area_57-Sottoarea_1",2015,5,57,54,111
"4014","Zona_21-Area_57-Sottoarea_1",2015,6,64,43,107
"4015","Zona_21-Area_57-Sottoarea_1",2015,7,65,44,109
"4016","Zona_21-Area_57-Sottoarea_1",2015,8,54,30,84
"4017","Zona_21-Area_57-Sottoarea_1",2015,9,65,34,99
"4018","Zona_21-Area_57-Sottoarea_1",2015,10,76,50,126
"4019","Zona_21-Area_57-Sottoarea_1",2015,11,66,47,113
"4020","Zona_21-Area_57-Sottoarea_1",2015,12,58,43,101
"4021","Zona_21-Area_57-Sottoarea_1",2016,1,69,42,111
"4022","Zona_21-Area_57-Sottoarea_1",2016,2,83,49,132
"4023","Zona_21-Area_57-Sottoarea_1",2016,3,89,57,146
"4024","Zona_21-Area_57-Sottoarea_1",2016,4,78,49,127
"4025","Zona_21-Area_57-Sottoarea_1",2016,5,44,27,71
"4026","Zona_21-Area_57-Sottoarea_1",2016,6,0,0,0
"4027","Zona_21-Area_57-Sottoarea_1",2016,7,0,0,0
"4028","Zona_21-Area_57-Sottoarea_1",2016,8,0,0,0
"4029","Zona_21-Area_57-Sottoarea_1",2016,9,0,0,0
"4030","Zona_21-Area_57-Sottoarea_1",2016,10,0,0,0
"4031","Zona_21-Area_57-Sottoarea_1",2016,11,0,0,0
"4032","Zona_21-Area_57-Sottoarea_1",2016,12,0,0,0
"4033","Zona_21-Area_57-Sottoarea_2",2014,1,123,60,183
"4034","Zona_21-Area_57-Sottoarea_2",2014,2,116,71,187
"4035","Zona_21-Area_57-Sottoarea_2",2014,3,96,53,149
"4036","Zona_21-Area_57-Sottoarea_2",2014,4,92,54,146
"4037","Zona_21-Area_57-Sottoarea_2",2014,5,84,48,132
"4038","Zona_21-Area_57-Sottoarea_2",2014,6,133,85,218
"4039","Zona_21-Area_57-Sottoarea_2",2014,7,105,60,165
"4040","Zona_21-Area_57-Sottoarea_2",2014,8,81,54,135
"4041","Zona_21-Area_57-Sottoarea_2",2014,9,105,59,164
"4042","Zona_21-Area_57-Sottoarea_2",2014,10,129,89,218
"4043","Zona_21-Area_57-Sottoarea_2",2014,11,125,70,195
"4044","Zona_21-Area_57-Sottoarea_2",2014,12,110,75,185
"4045","Zona_21-Area_57-Sottoarea_2",2015,1,112,79,191
"4046","Zona_21-Area_57-Sottoarea_2",2015,2,116,81,197
"4047","Zona_21-Area_57-Sottoarea_2",2015,3,125,110,235
"4048","Zona_21-Area_57-Sottoarea_2",2015,4,113,74,187
"4049","Zona_21-Area_57-Sottoarea_2",2015,5,100,88,188
"4050","Zona_21-Area_57-Sottoarea_2",2015,6,120,70,190
"4051","Zona_21-Area_57-Sottoarea_2",2015,7,128,67,195
"4052","Zona_21-Area_57-Sottoarea_2",2015,8,96,50,146
"4053","Zona_21-Area_57-Sottoarea_2",2015,9,125,65,190
"4054","Zona_21-Area_57-Sottoarea_2",2015,10,145,78,223
"4055","Zona_21-Area_57-Sottoarea_2",2015,11,120,70,190
"4056","Zona_21-Area_57-Sottoarea_2",2015,12,115,59,174
"4057","Zona_21-Area_57-Sottoarea_2",2016,1,117,59,176
"4058","Zona_21-Area_57-Sottoarea_2",2016,2,136,75,211
"4059","Zona_21-Area_57-Sottoarea_2",2016,3,144,84,228
"4060","Zona_21-Area_57-Sottoarea_2",2016,4,133,78,211
"4061","Zona_21-Area_57-Sottoarea_2",2016,5,79,48,127
"4062","Zona_21-Area_57-Sottoarea_2",2016,6,0,0,0
"4063","Zona_21-Area_57-Sottoarea_2",2016,7,0,0,0
"4064","Zona_21-Area_57-Sottoarea_2",2016,8,0,0,0
"4065","Zona_21-Area_57-Sottoarea_2",2016,9,0,0,0
"4066","Zona_21-Area_57-Sottoarea_2",2016,10,0,0,0
"4067","Zona_21-Area_57-Sottoarea_2",2016,11,0,0,0
"4068","Zona_21-Area_57-Sottoarea_2",2016,12,0,0,0
"4069","Zona_21-Area_58-Sottoarea_94",2014,1,116,82,198
"4070","Zona_21-Area_58-Sottoarea_94",2014,2,160,78,238
"4071","Zona_21-Area_58-Sottoarea_94",2014,3,150,66,216
"4072","Zona_21-Area_58-Sottoarea_94",2014,4,183,68,251
"4073","Zona_21-Area_58-Sottoarea_94",2014,5,166,57,223
"4074","Zona_21-Area_58-Sottoarea_94",2014,6,258,90,348
"4075","Zona_21-Area_58-Sottoarea_94",2014,7,174,66,240
"4076","Zona_21-Area_58-Sottoarea_94",2014,8,124,59,183
"4077","Zona_21-Area_58-Sottoarea_94",2014,9,148,45,193
"4078","Zona_21-Area_58-Sottoarea_94",2014,10,197,69,266
"4079","Zona_21-Area_58-Sottoarea_94",2014,11,188,64,252
"4080","Zona_21-Area_58-Sottoarea_94",2014,12,139,80,219
"4081","Zona_21-Area_58-Sottoarea_94",2015,1,141,66,207
"4082","Zona_21-Area_58-Sottoarea_94",2015,2,154,81,235
"4083","Zona_21-Area_58-Sottoarea_94",2015,3,161,100,261
"4084","Zona_21-Area_58-Sottoarea_94",2015,4,154,71,225
"4085","Zona_21-Area_58-Sottoarea_94",2015,5,149,68,217
"4086","Zona_21-Area_58-Sottoarea_94",2015,6,168,63,231
"4087","Zona_21-Area_58-Sottoarea_94",2015,7,143,67,210
"4088","Zona_21-Area_58-Sottoarea_94",2015,8,129,50,179
"4089","Zona_21-Area_58-Sottoarea_94",2015,9,172,64,236
"4090","Zona_21-Area_58-Sottoarea_94",2015,10,172,85,257
"4091","Zona_21-Area_58-Sottoarea_94",2015,11,147,73,220
"4092","Zona_21-Area_58-Sottoarea_94",2015,12,138,62,200
"4093","Zona_21-Area_58-Sottoarea_94",2016,1,146,48,194
"4094","Zona_21-Area_58-Sottoarea_94",2016,2,166,73,239
"4095","Zona_21-Area_58-Sottoarea_94",2016,3,180,91,271
"4096","Zona_21-Area_58-Sottoarea_94",2016,4,149,99,248
"4097","Zona_21-Area_58-Sottoarea_94",2016,5,91,65,156
"4098","Zona_21-Area_58-Sottoarea_94",2016,6,0,0,0
"4099","Zona_21-Area_58-Sottoarea_94",2016,7,0,0,0
"4100","Zona_21-Area_58-Sottoarea_94",2016,8,0,0,0
"4101","Zona_21-Area_58-Sottoarea_94",2016,9,0,0,0
"4102","Zona_21-Area_58-Sottoarea_94",2016,10,0,0,0
"4103","Zona_21-Area_58-Sottoarea_94",2016,11,0,0,0
"4104","Zona_21-Area_58-Sottoarea_94",2016,12,0,0,0
"4105","Zona_21-Area_58-Sottoarea_95",2014,1,86,49,135
"4106","Zona_21-Area_58-Sottoarea_95",2014,2,113,37,150
"4107","Zona_21-Area_58-Sottoarea_95",2014,3,80,31,111
"4108","Zona_21-Area_58-Sottoarea_95",2014,4,90,29,119
"4109","Zona_21-Area_58-Sottoarea_95",2014,5,87,24,111
"4110","Zona_21-Area_58-Sottoarea_95",2014,6,130,48,178
"4111","Zona_21-Area_58-Sottoarea_95",2014,7,93,29,122
"4112","Zona_21-Area_58-Sottoarea_95",2014,8,70,29,99
"4113","Zona_21-Area_58-Sottoarea_95",2014,9,92,21,113
"4114","Zona_21-Area_58-Sottoarea_95",2014,10,119,35,154
"4115","Zona_21-Area_58-Sottoarea_95",2014,11,107,32,139
"4116","Zona_21-Area_58-Sottoarea_95",2014,12,89,34,123
"4117","Zona_21-Area_58-Sottoarea_95",2015,1,91,32,123
"4118","Zona_21-Area_58-Sottoarea_95",2015,2,97,45,142
"4119","Zona_21-Area_58-Sottoarea_95",2015,3,106,59,165
"4120","Zona_21-Area_58-Sottoarea_95",2015,4,98,39,137
"4121","Zona_21-Area_58-Sottoarea_95",2015,5,92,41,133
"4122","Zona_21-Area_58-Sottoarea_95",2015,6,104,40,144
"4123","Zona_21-Area_58-Sottoarea_95",2015,7,103,40,143
"4124","Zona_21-Area_58-Sottoarea_95",2015,8,80,27,107
"4125","Zona_21-Area_58-Sottoarea_95",2015,9,104,36,140
"4126","Zona_21-Area_58-Sottoarea_95",2015,10,106,52,158
"4127","Zona_21-Area_58-Sottoarea_95",2015,11,94,40,134
"4128","Zona_21-Area_58-Sottoarea_95",2015,12,88,35,123
"4129","Zona_21-Area_58-Sottoarea_95",2016,1,93,33,126
"4130","Zona_21-Area_58-Sottoarea_95",2016,2,104,60,164
"4131","Zona_21-Area_58-Sottoarea_95",2016,3,107,63,170
"4132","Zona_21-Area_58-Sottoarea_95",2016,4,93,61,154
"4133","Zona_21-Area_58-Sottoarea_95",2016,5,62,51,113
"4134","Zona_21-Area_58-Sottoarea_95",2016,6,0,0,0
"4135","Zona_21-Area_58-Sottoarea_95",2016,7,0,0,0
"4136","Zona_21-Area_58-Sottoarea_95",2016,8,0,0,0
"4137","Zona_21-Area_58-Sottoarea_95",2016,9,0,0,0
"4138","Zona_21-Area_58-Sottoarea_95",2016,10,0,0,0
"4139","Zona_21-Area_58-Sottoarea_95",2016,11,0,0,0
"4140","Zona_21-Area_58-Sottoarea_95",2016,12,0,0,0
"4141","Zona_21-Area_59-Sottoarea_121",2014,1,167,105,272
"4142","Zona_21-Area_59-Sottoarea_121",2014,2,201,93,294
"4143","Zona_21-Area_59-Sottoarea_121",2014,3,161,76,237
"4144","Zona_21-Area_59-Sottoarea_121",2014,4,191,76,267
"4145","Zona_21-Area_59-Sottoarea_121",2014,5,179,60,239
"4146","Zona_21-Area_59-Sottoarea_121",2014,6,288,114,402
"4147","Zona_21-Area_59-Sottoarea_121",2014,7,197,79,276
"4148","Zona_21-Area_59-Sottoarea_121",2014,8,133,75,208
"4149","Zona_21-Area_59-Sottoarea_121",2014,9,182,58,240
"4150","Zona_21-Area_59-Sottoarea_121",2014,10,227,96,323
"4151","Zona_21-Area_59-Sottoarea_121",2014,11,207,99,306
"4152","Zona_21-Area_59-Sottoarea_121",2014,12,164,113,277
"4153","Zona_21-Area_59-Sottoarea_121",2015,1,177,90,267
"4154","Zona_21-Area_59-Sottoarea_121",2015,2,203,105,308
"4155","Zona_21-Area_59-Sottoarea_121",2015,3,222,130,352
"4156","Zona_21-Area_59-Sottoarea_121",2015,4,204,89,293
"4157","Zona_21-Area_59-Sottoarea_121",2015,5,181,96,277
"4158","Zona_21-Area_59-Sottoarea_121",2015,6,223,80,303
"4159","Zona_21-Area_59-Sottoarea_121",2015,7,196,83,279
"4160","Zona_21-Area_59-Sottoarea_121",2015,8,166,59,225
"4161","Zona_21-Area_59-Sottoarea_121",2015,9,221,81,302
"4162","Zona_21-Area_59-Sottoarea_121",2015,10,225,103,328
"4163","Zona_21-Area_59-Sottoarea_121",2015,11,201,89,290
"4164","Zona_21-Area_59-Sottoarea_121",2015,12,189,77,266
"4165","Zona_21-Area_59-Sottoarea_121",2016,1,195,61,256
"4166","Zona_21-Area_59-Sottoarea_121",2016,2,213,112,325
"4167","Zona_21-Area_59-Sottoarea_121",2016,3,234,141,375
"4168","Zona_21-Area_59-Sottoarea_121",2016,4,198,119,317
"4169","Zona_21-Area_59-Sottoarea_121",2016,5,120,88,208
"4170","Zona_21-Area_59-Sottoarea_121",2016,6,0,0,0
"4171","Zona_21-Area_59-Sottoarea_121",2016,7,0,0,0
"4172","Zona_21-Area_59-Sottoarea_121",2016,8,0,0,0
"4173","Zona_21-Area_59-Sottoarea_121",2016,9,0,0,0
"4174","Zona_21-Area_59-Sottoarea_121",2016,10,0,0,0
"4175","Zona_21-Area_59-Sottoarea_121",2016,11,0,0,0
"4176","Zona_21-Area_59-Sottoarea_121",2016,12,0,0,0
"4177","Zona_21-Area_59-Sottoarea_122",2014,1,59,48,107
"4178","Zona_21-Area_59-Sottoarea_122",2014,2,91,32,123
"4179","Zona_21-Area_59-Sottoarea_122",2014,3,78,28,106
"4180","Zona_21-Area_59-Sottoarea_122",2014,4,89,26,115
"4181","Zona_21-Area_59-Sottoarea_122",2014,5,73,21,94
"4182","Zona_21-Area_59-Sottoarea_122",2014,6,120,36,156
"4183","Zona_21-Area_59-Sottoarea_122",2014,7,82,28,110
"4184","Zona_21-Area_59-Sottoarea_122",2014,8,50,24,74
"4185","Zona_21-Area_59-Sottoarea_122",2014,9,78,20,98
"4186","Zona_21-Area_59-Sottoarea_122",2014,10,96,40,136
"4187","Zona_21-Area_59-Sottoarea_122",2014,11,92,25,117
"4188","Zona_21-Area_59-Sottoarea_122",2014,12,69,42,111
"4189","Zona_21-Area_59-Sottoarea_122",2015,1,69,32,101
"4190","Zona_21-Area_59-Sottoarea_122",2015,2,81,38,119
"4191","Zona_21-Area_59-Sottoarea_122",2015,3,83,44,127
"4192","Zona_21-Area_59-Sottoarea_122",2015,4,81,33,114
"4193","Zona_21-Area_59-Sottoarea_122",2015,5,79,36,115
"4194","Zona_21-Area_59-Sottoarea_122",2015,6,80,35,115
"4195","Zona_21-Area_59-Sottoarea_122",2015,7,76,34,110
"4196","Zona_21-Area_59-Sottoarea_122",2015,8,60,22,82
"4197","Zona_21-Area_59-Sottoarea_122",2015,9,83,31,114
"4198","Zona_21-Area_59-Sottoarea_122",2015,10,94,38,132
"4199","Zona_21-Area_59-Sottoarea_122",2015,11,77,35,112
"4200","Zona_21-Area_59-Sottoarea_122",2015,12,71,31,102
"4201","Zona_21-Area_59-Sottoarea_122",2016,1,74,26,100
"4202","Zona_21-Area_59-Sottoarea_122",2016,2,85,48,133
"4203","Zona_21-Area_59-Sottoarea_122",2016,3,87,53,140
"4204","Zona_21-Area_59-Sottoarea_122",2016,4,83,56,139
"4205","Zona_21-Area_59-Sottoarea_122",2016,5,50,42,92
"4206","Zona_21-Area_59-Sottoarea_122",2016,6,0,0,0
"4207","Zona_21-Area_59-Sottoarea_122",2016,7,0,0,0
"4208","Zona_21-Area_59-Sottoarea_122",2016,8,0,0,0
"4209","Zona_21-Area_59-Sottoarea_122",2016,9,0,0,0
"4210","Zona_21-Area_59-Sottoarea_122",2016,10,0,0,0
"4211","Zona_21-Area_59-Sottoarea_122",2016,11,0,0,0
"4212","Zona_21-Area_59-Sottoarea_122",2016,12,0,0,0
"4213","Zona_22-Area_68-Sottoarea_11",2014,1,117,38,155
"4214","Zona_22-Area_68-Sottoarea_11",2014,2,117,42,159
"4215","Zona_22-Area_68-Sottoarea_11",2014,3,87,28,115
"4216","Zona_22-Area_68-Sottoarea_11",2014,4,112,40,152
"4217","Zona_22-Area_68-Sottoarea_11",2014,5,106,40,146
"4218","Zona_22-Area_68-Sottoarea_11",2014,6,101,32,133
"4219","Zona_22-Area_68-Sottoarea_11",2014,7,105,35,140
"4220","Zona_22-Area_68-Sottoarea_11",2014,8,84,26,110
"4221","Zona_22-Area_68-Sottoarea_11",2014,9,108,35,143
"4222","Zona_22-Area_68-Sottoarea_11",2014,10,130,51,181
"4223","Zona_22-Area_68-Sottoarea_11",2014,11,131,48,179
"4224","Zona_22-Area_68-Sottoarea_11",2014,12,103,53,156
"4225","Zona_22-Area_68-Sottoarea_11",2015,1,123,38,161
"4226","Zona_22-Area_68-Sottoarea_11",2015,2,112,42,154
"4227","Zona_22-Area_68-Sottoarea_11",2015,3,117,86,203
"4228","Zona_22-Area_68-Sottoarea_11",2015,4,112,66,178
"4229","Zona_22-Area_68-Sottoarea_11",2015,5,115,58,173
"4230","Zona_22-Area_68-Sottoarea_11",2015,6,106,42,148
"4231","Zona_22-Area_68-Sottoarea_11",2015,7,105,40,145
"4232","Zona_22-Area_68-Sottoarea_11",2015,8,61,29,90
"4233","Zona_22-Area_68-Sottoarea_11",2015,9,156,39,195
"4234","Zona_22-Area_68-Sottoarea_11",2015,10,129,52,181
"4235","Zona_22-Area_68-Sottoarea_11",2015,11,147,46,193
"4236","Zona_22-Area_68-Sottoarea_11",2015,12,120,40,160
"4237","Zona_22-Area_68-Sottoarea_11",2016,1,145,38,183
"4238","Zona_22-Area_68-Sottoarea_11",2016,2,129,41,170
"4239","Zona_22-Area_68-Sottoarea_11",2016,3,146,55,201
"4240","Zona_22-Area_68-Sottoarea_11",2016,4,128,41,169
"4241","Zona_22-Area_68-Sottoarea_11",2016,5,84,25,109
"4242","Zona_22-Area_68-Sottoarea_11",2016,6,0,0,0
"4243","Zona_22-Area_68-Sottoarea_11",2016,7,0,0,0
"4244","Zona_22-Area_68-Sottoarea_11",2016,8,0,0,0
"4245","Zona_22-Area_68-Sottoarea_11",2016,9,0,0,0
"4246","Zona_22-Area_68-Sottoarea_11",2016,10,0,0,0
"4247","Zona_22-Area_68-Sottoarea_11",2016,11,0,0,0
"4248","Zona_22-Area_68-Sottoarea_11",2016,12,0,0,0
"4249","Zona_22-Area_68-Sottoarea_12",2014,1,84,45,129
"4250","Zona_22-Area_68-Sottoarea_12",2014,2,96,46,142
"4251","Zona_22-Area_68-Sottoarea_12",2014,3,69,39,108
"4252","Zona_22-Area_68-Sottoarea_12",2014,4,86,48,134
"4253","Zona_22-Area_68-Sottoarea_12",2014,5,97,44,141
"4254","Zona_22-Area_68-Sottoarea_12",2014,6,81,37,118
"4255","Zona_22-Area_68-Sottoarea_12",2014,7,89,41,130
"4256","Zona_22-Area_68-Sottoarea_12",2014,8,76,27,103
"4257","Zona_22-Area_68-Sottoarea_12",2014,9,90,28,118
"4258","Zona_22-Area_68-Sottoarea_12",2014,10,102,48,150
"4259","Zona_22-Area_68-Sottoarea_12",2014,11,98,46,144
"4260","Zona_22-Area_68-Sottoarea_12",2014,12,82,42,124
"4261","Zona_22-Area_68-Sottoarea_12",2015,1,88,49,137
"4262","Zona_22-Area_68-Sottoarea_12",2015,2,99,55,154
"4263","Zona_22-Area_68-Sottoarea_12",2015,3,103,95,198
"4264","Zona_22-Area_68-Sottoarea_12",2015,4,94,89,183
"4265","Zona_22-Area_68-Sottoarea_12",2015,5,109,67,176
"4266","Zona_22-Area_68-Sottoarea_12",2015,6,79,64,143
"4267","Zona_22-Area_68-Sottoarea_12",2015,7,90,62,152
"4268","Zona_22-Area_68-Sottoarea_12",2015,8,59,44,103
"4269","Zona_22-Area_68-Sottoarea_12",2015,9,110,40,150
"4270","Zona_22-Area_68-Sottoarea_12",2015,10,98,64,162
"4271","Zona_22-Area_68-Sottoarea_12",2015,11,97,52,149
"4272","Zona_22-Area_68-Sottoarea_12",2015,12,89,45,134
"4273","Zona_22-Area_68-Sottoarea_12",2016,1,105,41,146
"4274","Zona_22-Area_68-Sottoarea_12",2016,2,107,55,162
"4275","Zona_22-Area_68-Sottoarea_12",2016,3,114,60,174
"4276","Zona_22-Area_68-Sottoarea_12",2016,4,92,51,143
"4277","Zona_22-Area_68-Sottoarea_12",2016,5,57,25,82
"4278","Zona_22-Area_68-Sottoarea_12",2016,6,0,0,0
"4279","Zona_22-Area_68-Sottoarea_12",2016,7,0,0,0
"4280","Zona_22-Area_68-Sottoarea_12",2016,8,0,0,0
"4281","Zona_22-Area_68-Sottoarea_12",2016,9,0,0,0
"4282","Zona_22-Area_68-Sottoarea_12",2016,10,0,0,0
"4283","Zona_22-Area_68-Sottoarea_12",2016,11,0,0,0
"4284","Zona_22-Area_68-Sottoarea_12",2016,12,0,0,0
"4285","Zona_22-Area_69-Sottoarea_132",2014,1,125,73,198
"4286","Zona_22-Area_69-Sottoarea_132",2014,2,157,43,200
"4287","Zona_22-Area_69-Sottoarea_132",2014,3,120,38,158
"4288","Zona_22-Area_69-Sottoarea_132",2014,4,159,50,209
"4289","Zona_22-Area_69-Sottoarea_132",2014,5,143,41,184
"4290","Zona_22-Area_69-Sottoarea_132",2014,6,144,40,184
"4291","Zona_22-Area_69-Sottoarea_132",2014,7,157,40,197
"4292","Zona_22-Area_69-Sottoarea_132",2014,8,105,23,128
"4293","Zona_22-Area_69-Sottoarea_132",2014,9,175,36,211
"4294","Zona_22-Area_69-Sottoarea_132",2014,10,196,46,242
"4295","Zona_22-Area_69-Sottoarea_132",2014,11,191,43,234
"4296","Zona_22-Area_69-Sottoarea_132",2014,12,129,43,172
"4297","Zona_22-Area_69-Sottoarea_132",2015,1,125,46,171
"4298","Zona_22-Area_69-Sottoarea_132",2015,2,144,57,201
"4299","Zona_22-Area_69-Sottoarea_132",2015,3,145,86,231
"4300","Zona_22-Area_69-Sottoarea_132",2015,4,132,64,196
"4301","Zona_22-Area_69-Sottoarea_132",2015,5,133,59,192
"4302","Zona_22-Area_69-Sottoarea_132",2015,6,135,51,186
"4303","Zona_22-Area_69-Sottoarea_132",2015,7,141,51,192
"4304","Zona_22-Area_69-Sottoarea_132",2015,8,88,32,120
"4305","Zona_22-Area_69-Sottoarea_132",2015,9,155,38,193
"4306","Zona_22-Area_69-Sottoarea_132",2015,10,177,52,229
"4307","Zona_22-Area_69-Sottoarea_132",2015,11,145,42,187
"4308","Zona_22-Area_69-Sottoarea_132",2015,12,123,43,166
"4309","Zona_22-Area_69-Sottoarea_132",2016,1,148,36,184
"4310","Zona_22-Area_69-Sottoarea_132",2016,2,157,48,205
"4311","Zona_22-Area_69-Sottoarea_132",2016,3,158,50,208
"4312","Zona_22-Area_69-Sottoarea_132",2016,4,140,72,212
"4313","Zona_22-Area_69-Sottoarea_132",2016,5,92,28,120
"4314","Zona_22-Area_69-Sottoarea_132",2016,6,0,0,0
"4315","Zona_22-Area_69-Sottoarea_132",2016,7,0,0,0
"4316","Zona_22-Area_69-Sottoarea_132",2016,8,0,0,0
"4317","Zona_22-Area_69-Sottoarea_132",2016,9,0,0,0
"4318","Zona_22-Area_69-Sottoarea_132",2016,10,0,0,0
"4319","Zona_22-Area_69-Sottoarea_132",2016,11,0,0,0
"4320","Zona_22-Area_69-Sottoarea_132",2016,12,0,0,0
"4321","Zona_22-Area_69-Sottoarea_133",2014,1,185,94,279
"4322","Zona_22-Area_69-Sottoarea_133",2014,2,224,61,285
"4323","Zona_22-Area_69-Sottoarea_133",2014,3,182,50,232
"4324","Zona_22-Area_69-Sottoarea_133",2014,4,226,62,288
"4325","Zona_22-Area_69-Sottoarea_133",2014,5,226,58,284
"4326","Zona_22-Area_69-Sottoarea_133",2014,6,216,49,265
"4327","Zona_22-Area_69-Sottoarea_133",2014,7,240,52,292
"4328","Zona_22-Area_69-Sottoarea_133",2014,8,140,36,176
"4329","Zona_22-Area_69-Sottoarea_133",2014,9,228,45,273
"4330","Zona_22-Area_69-Sottoarea_133",2014,10,305,70,375
"4331","Zona_22-Area_69-Sottoarea_133",2014,11,270,55,325
"4332","Zona_22-Area_69-Sottoarea_133",2014,12,188,65,253
"4333","Zona_22-Area_69-Sottoarea_133",2015,1,186,57,243
"4334","Zona_22-Area_69-Sottoarea_133",2015,2,217,86,303
"4335","Zona_22-Area_69-Sottoarea_133",2015,3,223,91,314
"4336","Zona_22-Area_69-Sottoarea_133",2015,4,206,90,296
"4337","Zona_22-Area_69-Sottoarea_133",2015,5,193,95,288
"4338","Zona_22-Area_69-Sottoarea_133",2015,6,191,66,257
"4339","Zona_22-Area_69-Sottoarea_133",2015,7,198,66,264
"4340","Zona_22-Area_69-Sottoarea_133",2015,8,118,41,159
"4341","Zona_22-Area_69-Sottoarea_133",2015,9,239,51,290
"4342","Zona_22-Area_69-Sottoarea_133",2015,10,243,72,315
"4343","Zona_22-Area_69-Sottoarea_133",2015,11,208,61,269
"4344","Zona_22-Area_69-Sottoarea_133",2015,12,192,54,246
"4345","Zona_22-Area_69-Sottoarea_133",2016,1,206,47,253
"4346","Zona_22-Area_69-Sottoarea_133",2016,2,208,54,262
"4347","Zona_22-Area_69-Sottoarea_133",2016,3,218,71,289
"4348","Zona_22-Area_69-Sottoarea_133",2016,4,181,92,273
"4349","Zona_22-Area_69-Sottoarea_133",2016,5,124,45,169
"4350","Zona_22-Area_69-Sottoarea_133",2016,6,0,0,0
"4351","Zona_22-Area_69-Sottoarea_133",2016,7,0,0,0
"4352","Zona_22-Area_69-Sottoarea_133",2016,8,0,0,0
"4353","Zona_22-Area_69-Sottoarea_133",2016,9,0,0,0
"4354","Zona_22-Area_69-Sottoarea_133",2016,10,0,0,0
"4355","Zona_22-Area_69-Sottoarea_133",2016,11,0,0,0
"4356","Zona_22-Area_69-Sottoarea_133",2016,12,0,0,0
"4357","Zona_22-Area_70-Sottoarea_134",2014,1,36,21,57
"4358","Zona_22-Area_70-Sottoarea_134",2014,2,35,23,58
"4359","Zona_22-Area_70-Sottoarea_134",2014,3,25,18,43
"4360","Zona_22-Area_70-Sottoarea_134",2014,4,36,22,58
"4361","Zona_22-Area_70-Sottoarea_134",2014,5,37,20,57
"4362","Zona_22-Area_70-Sottoarea_134",2014,6,32,18,50
"4363","Zona_22-Area_70-Sottoarea_134",2014,7,40,18,58
"4364","Zona_22-Area_70-Sottoarea_134",2014,8,25,17,42
"4365","Zona_22-Area_70-Sottoarea_134",2014,9,40,17,57
"4366","Zona_22-Area_70-Sottoarea_134",2014,10,53,24,77
"4367","Zona_22-Area_70-Sottoarea_134",2014,11,44,25,69
"4368","Zona_22-Area_70-Sottoarea_134",2014,12,35,19,54
"4369","Zona_22-Area_70-Sottoarea_134",2015,1,41,20,61
"4370","Zona_22-Area_70-Sottoarea_134",2015,2,46,27,73
"4371","Zona_22-Area_70-Sottoarea_134",2015,3,51,59,110
"4372","Zona_22-Area_70-Sottoarea_134",2015,4,43,54,97
"4373","Zona_22-Area_70-Sottoarea_134",2015,5,47,35,82
"4374","Zona_22-Area_70-Sottoarea_134",2015,6,42,33,75
"4375","Zona_22-Area_70-Sottoarea_134",2015,7,46,27,73
"4376","Zona_22-Area_70-Sottoarea_134",2015,8,25,17,42
"4377","Zona_22-Area_70-Sottoarea_134",2015,9,53,22,75
"4378","Zona_22-Area_70-Sottoarea_134",2015,10,49,30,79
"4379","Zona_22-Area_70-Sottoarea_134",2015,11,45,29,74
"4380","Zona_22-Area_70-Sottoarea_134",2015,12,45,28,73
"4381","Zona_22-Area_70-Sottoarea_134",2016,1,46,23,69
"4382","Zona_22-Area_70-Sottoarea_134",2016,2,45,27,72
"4383","Zona_22-Area_70-Sottoarea_134",2016,3,52,28,80
"4384","Zona_22-Area_70-Sottoarea_134",2016,4,45,25,70
"4385","Zona_22-Area_70-Sottoarea_134",2016,5,28,16,44
"4386","Zona_22-Area_70-Sottoarea_134",2016,6,0,0,0
"4387","Zona_22-Area_70-Sottoarea_134",2016,7,0,0,0
"4388","Zona_22-Area_70-Sottoarea_134",2016,8,0,0,0
"4389","Zona_22-Area_70-Sottoarea_134",2016,9,0,0,0
"4390","Zona_22-Area_70-Sottoarea_134",2016,10,0,0,0
"4391","Zona_22-Area_70-Sottoarea_134",2016,11,0,0,0
"4392","Zona_22-Area_70-Sottoarea_134",2016,12,0,0,0
"4393","Zona_22-Area_70-Sottoarea_135",2014,1,157,78,235
"4394","Zona_22-Area_70-Sottoarea_135",2014,2,152,82,234
"4395","Zona_22-Area_70-Sottoarea_135",2014,3,123,64,187
"4396","Zona_22-Area_70-Sottoarea_135",2014,4,135,80,215
"4397","Zona_22-Area_70-Sottoarea_135",2014,5,155,75,230
"4398","Zona_22-Area_70-Sottoarea_135",2014,6,145,67,212
"4399","Zona_22-Area_70-Sottoarea_135",2014,7,172,74,246
"4400","Zona_22-Area_70-Sottoarea_135",2014,8,119,56,175
"4401","Zona_22-Area_70-Sottoarea_135",2014,9,151,77,228
"4402","Zona_22-Area_70-Sottoarea_135",2014,10,180,94,274
"4403","Zona_22-Area_70-Sottoarea_135",2014,11,171,107,278
"4404","Zona_22-Area_70-Sottoarea_135",2014,12,151,89,240
"4405","Zona_22-Area_70-Sottoarea_135",2015,1,179,81,260
"4406","Zona_22-Area_70-Sottoarea_135",2015,2,170,95,265
"4407","Zona_22-Area_70-Sottoarea_135",2015,3,188,145,333
"4408","Zona_22-Area_70-Sottoarea_135",2015,4,148,115,263
"4409","Zona_22-Area_70-Sottoarea_135",2015,5,159,99,258
"4410","Zona_22-Area_70-Sottoarea_135",2015,6,151,80,231
"4411","Zona_22-Area_70-Sottoarea_135",2015,7,147,77,224
"4412","Zona_22-Area_70-Sottoarea_135",2015,8,98,77,175
"4413","Zona_22-Area_70-Sottoarea_135",2015,9,195,82,277
"4414","Zona_22-Area_70-Sottoarea_135",2015,10,192,129,321
"4415","Zona_22-Area_70-Sottoarea_135",2015,11,190,139,329
"4416","Zona_22-Area_70-Sottoarea_135",2015,12,173,86,259
"4417","Zona_22-Area_70-Sottoarea_135",2016,1,194,85,279
"4418","Zona_22-Area_70-Sottoarea_135",2016,2,195,113,308
"4419","Zona_22-Area_70-Sottoarea_135",2016,3,202,105,307
"4420","Zona_22-Area_70-Sottoarea_135",2016,4,179,88,267
"4421","Zona_22-Area_70-Sottoarea_135",2016,5,113,57,170
"4422","Zona_22-Area_70-Sottoarea_135",2016,6,0,0,0
"4423","Zona_22-Area_70-Sottoarea_135",2016,7,0,0,0
"4424","Zona_22-Area_70-Sottoarea_135",2016,8,0,0,0
"4425","Zona_22-Area_70-Sottoarea_135",2016,9,0,0,0
"4426","Zona_22-Area_70-Sottoarea_135",2016,10,0,0,0
"4427","Zona_22-Area_70-Sottoarea_135",2016,11,0,0,0
"4428","Zona_22-Area_70-Sottoarea_135",2016,12,0,0,0
"4429","Zona_22-Area_70-Sottoarea_136",2014,1,32,23,55
"4430","Zona_22-Area_70-Sottoarea_136",2014,2,48,24,72
"4431","Zona_22-Area_70-Sottoarea_136",2014,3,36,20,56
"4432","Zona_22-Area_70-Sottoarea_136",2014,4,38,20,58
"4433","Zona_22-Area_70-Sottoarea_136",2014,5,36,20,56
"4434","Zona_22-Area_70-Sottoarea_136",2014,6,34,17,51
"4435","Zona_22-Area_70-Sottoarea_136",2014,7,45,23,68
"4436","Zona_22-Area_70-Sottoarea_136",2014,8,28,15,43
"4437","Zona_22-Area_70-Sottoarea_136",2014,9,41,15,56
"4438","Zona_22-Area_70-Sottoarea_136",2014,10,48,25,73
"4439","Zona_22-Area_70-Sottoarea_136",2014,11,46,20,66
"4440","Zona_22-Area_70-Sottoarea_136",2014,12,36,24,60
"4441","Zona_22-Area_70-Sottoarea_136",2015,1,36,22,58
"4442","Zona_22-Area_70-Sottoarea_136",2015,2,45,25,70
"4443","Zona_22-Area_70-Sottoarea_136",2015,3,45,31,76
"4444","Zona_22-Area_70-Sottoarea_136",2015,4,45,44,89
"4445","Zona_22-Area_70-Sottoarea_136",2015,5,47,42,89
"4446","Zona_22-Area_70-Sottoarea_136",2015,6,40,41,81
"4447","Zona_22-Area_70-Sottoarea_136",2015,7,47,37,84
"4448","Zona_22-Area_70-Sottoarea_136",2015,8,27,22,49
"4449","Zona_22-Area_70-Sottoarea_136",2015,9,52,35,87
"4450","Zona_22-Area_70-Sottoarea_136",2015,10,50,29,79
"4451","Zona_22-Area_70-Sottoarea_136",2015,11,43,32,75
"4452","Zona_22-Area_70-Sottoarea_136",2015,12,45,40,85
"4453","Zona_22-Area_70-Sottoarea_136",2016,1,49,21,70
"4454","Zona_22-Area_70-Sottoarea_136",2016,2,50,26,76
"4455","Zona_22-Area_70-Sottoarea_136",2016,3,53,28,81
"4456","Zona_22-Area_70-Sottoarea_136",2016,4,48,32,80
"4457","Zona_22-Area_70-Sottoarea_136",2016,5,32,16,48
"4458","Zona_22-Area_70-Sottoarea_136",2016,6,0,0,0
"4459","Zona_22-Area_70-Sottoarea_136",2016,7,0,0,0
"4460","Zona_22-Area_70-Sottoarea_136",2016,8,0,0,0
"4461","Zona_22-Area_70-Sottoarea_136",2016,9,0,0,0
"4462","Zona_22-Area_70-Sottoarea_136",2016,10,0,0,0
"4463","Zona_22-Area_70-Sottoarea_136",2016,11,0,0,0
"4464","Zona_22-Area_70-Sottoarea_136",2016,12,0,0,0
"4465","Zona_23-Area_62-Sottoarea_123",2014,1,82,39,121
"4466","Zona_23-Area_62-Sottoarea_123",2014,2,78,40,118
"4467","Zona_23-Area_62-Sottoarea_123",2014,3,58,30,88
"4468","Zona_23-Area_62-Sottoarea_123",2014,4,75,36,111
"4469","Zona_23-Area_62-Sottoarea_123",2014,5,90,31,121
"4470","Zona_23-Area_62-Sottoarea_123",2014,6,86,29,115
"4471","Zona_23-Area_62-Sottoarea_123",2014,7,90,31,121
"4472","Zona_23-Area_62-Sottoarea_123",2014,8,54,25,79
"4473","Zona_23-Area_62-Sottoarea_123",2014,9,108,26,134
"4474","Zona_23-Area_62-Sottoarea_123",2014,10,129,46,175
"4475","Zona_23-Area_62-Sottoarea_123",2014,11,111,35,146
"4476","Zona_23-Area_62-Sottoarea_123",2014,12,95,35,130
"4477","Zona_23-Area_62-Sottoarea_123",2015,1,107,54,161
"4478","Zona_23-Area_62-Sottoarea_123",2015,2,102,45,147
"4479","Zona_23-Area_62-Sottoarea_123",2015,3,120,45,165
"4480","Zona_23-Area_62-Sottoarea_123",2015,4,92,45,137
"4481","Zona_23-Area_62-Sottoarea_123",2015,5,97,44,141
"4482","Zona_23-Area_62-Sottoarea_123",2015,6,95,44,139
"4483","Zona_23-Area_62-Sottoarea_123",2015,7,96,38,134
"4484","Zona_23-Area_62-Sottoarea_123",2015,8,67,27,94
"4485","Zona_23-Area_62-Sottoarea_123",2015,9,113,56,169
"4486","Zona_23-Area_62-Sottoarea_123",2015,10,130,48,178
"4487","Zona_23-Area_62-Sottoarea_123",2015,11,114,39,153
"4488","Zona_23-Area_62-Sottoarea_123",2015,12,101,36,137
"4489","Zona_23-Area_62-Sottoarea_123",2016,1,106,34,140
"4490","Zona_23-Area_62-Sottoarea_123",2016,2,113,67,180
"4491","Zona_23-Area_62-Sottoarea_123",2016,3,120,62,182
"4492","Zona_23-Area_62-Sottoarea_123",2016,4,106,50,156
"4493","Zona_23-Area_62-Sottoarea_123",2016,5,66,41,107
"4494","Zona_23-Area_62-Sottoarea_123",2016,6,0,0,0
"4495","Zona_23-Area_62-Sottoarea_123",2016,7,0,0,0
"4496","Zona_23-Area_62-Sottoarea_123",2016,8,0,0,0
"4497","Zona_23-Area_62-Sottoarea_123",2016,9,0,0,0
"4498","Zona_23-Area_62-Sottoarea_123",2016,10,0,0,0
"4499","Zona_23-Area_62-Sottoarea_123",2016,11,0,0,0
"4500","Zona_23-Area_62-Sottoarea_123",2016,12,0,0,0
"4501","Zona_23-Area_62-Sottoarea_124",2014,1,129,59,188
"4502","Zona_23-Area_62-Sottoarea_124",2014,2,122,57,179
"4503","Zona_23-Area_62-Sottoarea_124",2014,3,106,49,155
"4504","Zona_23-Area_62-Sottoarea_124",2014,4,128,51,179
"4505","Zona_23-Area_62-Sottoarea_124",2014,5,144,53,197
"4506","Zona_23-Area_62-Sottoarea_124",2014,6,127,51,178
"4507","Zona_23-Area_62-Sottoarea_124",2014,7,130,54,184
"4508","Zona_23-Area_62-Sottoarea_124",2014,8,80,35,115
"4509","Zona_23-Area_62-Sottoarea_124",2014,9,130,42,172
"4510","Zona_23-Area_62-Sottoarea_124",2014,10,174,84,258
"4511","Zona_23-Area_62-Sottoarea_124",2014,11,154,66,220
"4512","Zona_23-Area_62-Sottoarea_124",2014,12,144,52,196
"4513","Zona_23-Area_62-Sottoarea_124",2015,1,151,72,223
"4514","Zona_23-Area_62-Sottoarea_124",2015,2,165,66,231
"4515","Zona_23-Area_62-Sottoarea_124",2015,3,184,72,256
"4516","Zona_23-Area_62-Sottoarea_124",2015,4,154,72,226
"4517","Zona_23-Area_62-Sottoarea_124",2015,5,158,79,237
"4518","Zona_23-Area_62-Sottoarea_124",2015,6,160,63,223
"4519","Zona_23-Area_62-Sottoarea_124",2015,7,156,61,217
"4520","Zona_23-Area_62-Sottoarea_124",2015,8,111,43,154
"4521","Zona_23-Area_62-Sottoarea_124",2015,9,182,62,244
"4522","Zona_23-Area_62-Sottoarea_124",2015,10,193,97,290
"4523","Zona_23-Area_62-Sottoarea_124",2015,11,183,76,259
"4524","Zona_23-Area_62-Sottoarea_124",2015,12,150,59,209
"4525","Zona_23-Area_62-Sottoarea_124",2016,1,156,59,215
"4526","Zona_23-Area_62-Sottoarea_124",2016,2,173,64,237
"4527","Zona_23-Area_62-Sottoarea_124",2016,3,195,92,287
"4528","Zona_23-Area_62-Sottoarea_124",2016,4,170,75,245
"4529","Zona_23-Area_62-Sottoarea_124",2016,5,102,46,148
"4530","Zona_23-Area_62-Sottoarea_124",2016,6,0,0,0
"4531","Zona_23-Area_62-Sottoarea_124",2016,7,0,0,0
"4532","Zona_23-Area_62-Sottoarea_124",2016,8,0,0,0
"4533","Zona_23-Area_62-Sottoarea_124",2016,9,0,0,0
"4534","Zona_23-Area_62-Sottoarea_124",2016,10,0,0,0
"4535","Zona_23-Area_62-Sottoarea_124",2016,11,0,0,0
"4536","Zona_23-Area_62-Sottoarea_124",2016,12,0,0,0
"4537","Zona_23-Area_63-Sottoarea_125",2014,1,149,68,217
"4538","Zona_23-Area_63-Sottoarea_125",2014,2,132,69,201
"4539","Zona_23-Area_63-Sottoarea_125",2014,3,116,63,179
"4540","Zona_23-Area_63-Sottoarea_125",2014,4,142,65,207
"4541","Zona_23-Area_63-Sottoarea_125",2014,5,147,63,210
"4542","Zona_23-Area_63-Sottoarea_125",2014,6,127,61,188
"4543","Zona_23-Area_63-Sottoarea_125",2014,7,145,58,203
"4544","Zona_23-Area_63-Sottoarea_125",2014,8,92,52,144
"4545","Zona_23-Area_63-Sottoarea_125",2014,9,135,47,182
"4546","Zona_23-Area_63-Sottoarea_125",2014,10,161,76,237
"4547","Zona_23-Area_63-Sottoarea_125",2014,11,149,73,222
"4548","Zona_23-Area_63-Sottoarea_125",2014,12,150,57,207
"4549","Zona_23-Area_63-Sottoarea_125",2015,1,162,88,250
"4550","Zona_23-Area_63-Sottoarea_125",2015,2,159,81,240
"4551","Zona_23-Area_63-Sottoarea_125",2015,3,173,78,251
"4552","Zona_23-Area_63-Sottoarea_125",2015,4,141,72,213
"4553","Zona_23-Area_63-Sottoarea_125",2015,5,149,102,251
"4554","Zona_23-Area_63-Sottoarea_125",2015,6,142,78,220
"4555","Zona_23-Area_63-Sottoarea_125",2015,7,156,70,226
"4556","Zona_23-Area_63-Sottoarea_125",2015,8,107,48,155
"4557","Zona_23-Area_63-Sottoarea_125",2015,9,163,82,245
"4558","Zona_23-Area_63-Sottoarea_125",2015,10,184,89,273
"4559","Zona_23-Area_63-Sottoarea_125",2015,11,180,77,257
"4560","Zona_23-Area_63-Sottoarea_125",2015,12,164,66,230
"4561","Zona_23-Area_63-Sottoarea_125",2016,1,191,64,255
"4562","Zona_23-Area_63-Sottoarea_125",2016,2,207,91,298
"4563","Zona_23-Area_63-Sottoarea_125",2016,3,222,96,318
"4564","Zona_23-Area_63-Sottoarea_125",2016,4,225,79,304
"4565","Zona_23-Area_63-Sottoarea_125",2016,5,126,60,186
"4566","Zona_23-Area_63-Sottoarea_125",2016,6,0,0,0
"4567","Zona_23-Area_63-Sottoarea_125",2016,7,0,0,0
"4568","Zona_23-Area_63-Sottoarea_125",2016,8,0,0,0
"4569","Zona_23-Area_63-Sottoarea_125",2016,9,0,0,0
"4570","Zona_23-Area_63-Sottoarea_125",2016,10,0,0,0
"4571","Zona_23-Area_63-Sottoarea_125",2016,11,0,0,0
"4572","Zona_23-Area_63-Sottoarea_125",2016,12,0,0,0
"4573","Zona_23-Area_63-Sottoarea_126",2014,1,108,52,160
"4574","Zona_23-Area_63-Sottoarea_126",2014,2,109,53,162
"4575","Zona_23-Area_63-Sottoarea_126",2014,3,87,39,126
"4576","Zona_23-Area_63-Sottoarea_126",2014,4,109,41,150
"4577","Zona_23-Area_63-Sottoarea_126",2014,5,110,40,150
"4578","Zona_23-Area_63-Sottoarea_126",2014,6,94,36,130
"4579","Zona_23-Area_63-Sottoarea_126",2014,7,113,46,159
"4580","Zona_23-Area_63-Sottoarea_126",2014,8,77,32,109
"4581","Zona_23-Area_63-Sottoarea_126",2014,9,122,32,154
"4582","Zona_23-Area_63-Sottoarea_126",2014,10,146,52,198
"4583","Zona_23-Area_63-Sottoarea_126",2014,11,132,65,197
"4584","Zona_23-Area_63-Sottoarea_126",2014,12,120,55,175
"4585","Zona_23-Area_63-Sottoarea_126",2015,1,123,53,176
"4586","Zona_23-Area_63-Sottoarea_126",2015,2,127,64,191
"4587","Zona_23-Area_63-Sottoarea_126",2015,3,139,79,218
"4588","Zona_23-Area_63-Sottoarea_126",2015,4,113,69,182
"4589","Zona_23-Area_63-Sottoarea_126",2015,5,122,61,183
"4590","Zona_23-Area_63-Sottoarea_126",2015,6,111,52,163
"4591","Zona_23-Area_63-Sottoarea_126",2015,7,119,73,192
"4592","Zona_23-Area_63-Sottoarea_126",2015,8,92,49,141
"4593","Zona_23-Area_63-Sottoarea_126",2015,9,141,92,233
"4594","Zona_23-Area_63-Sottoarea_126",2015,10,162,85,247
"4595","Zona_23-Area_63-Sottoarea_126",2015,11,153,64,217
"4596","Zona_23-Area_63-Sottoarea_126",2015,12,144,55,199
"4597","Zona_23-Area_63-Sottoarea_126",2016,1,144,57,201
"4598","Zona_23-Area_63-Sottoarea_126",2016,2,149,73,222
"4599","Zona_23-Area_63-Sottoarea_126",2016,3,168,93,261
"4600","Zona_23-Area_63-Sottoarea_126",2016,4,133,65,198
"4601","Zona_23-Area_63-Sottoarea_126",2016,5,86,45,131
"4602","Zona_23-Area_63-Sottoarea_126",2016,6,0,0,0
"4603","Zona_23-Area_63-Sottoarea_126",2016,7,0,0,0
"4604","Zona_23-Area_63-Sottoarea_126",2016,8,0,0,0
"4605","Zona_23-Area_63-Sottoarea_126",2016,9,0,0,0
"4606","Zona_23-Area_63-Sottoarea_126",2016,10,0,0,0
"4607","Zona_23-Area_63-Sottoarea_126",2016,11,0,0,0
"4608","Zona_23-Area_63-Sottoarea_126",2016,12,0,0,0
"4609","Zona_23-Area_64-Sottoarea_127",2014,1,146,59,205
"4610","Zona_23-Area_64-Sottoarea_127",2014,2,137,65,202
"4611","Zona_23-Area_64-Sottoarea_127",2014,3,121,48,169
"4612","Zona_23-Area_64-Sottoarea_127",2014,4,145,64,209
"4613","Zona_23-Area_64-Sottoarea_127",2014,5,166,62,228
"4614","Zona_23-Area_64-Sottoarea_127",2014,6,143,55,198
"4615","Zona_23-Area_64-Sottoarea_127",2014,7,157,54,211
"4616","Zona_23-Area_64-Sottoarea_127",2014,8,111,42,153
"4617","Zona_23-Area_64-Sottoarea_127",2014,9,159,49,208
"4618","Zona_23-Area_64-Sottoarea_127",2014,10,214,78,292
"4619","Zona_23-Area_64-Sottoarea_127",2014,11,177,80,257
"4620","Zona_23-Area_64-Sottoarea_127",2014,12,154,77,231
"4621","Zona_23-Area_64-Sottoarea_127",2015,1,177,73,250
"4622","Zona_23-Area_64-Sottoarea_127",2015,2,183,103,286
"4623","Zona_23-Area_64-Sottoarea_127",2015,3,207,81,288
"4624","Zona_23-Area_64-Sottoarea_127",2015,4,176,86,262
"4625","Zona_23-Area_64-Sottoarea_127",2015,5,176,93,269
"4626","Zona_23-Area_64-Sottoarea_127",2015,6,163,76,239
"4627","Zona_23-Area_64-Sottoarea_127",2015,7,159,73,232
"4628","Zona_23-Area_64-Sottoarea_127",2015,8,120,52,172
"4629","Zona_23-Area_64-Sottoarea_127",2015,9,185,69,254
"4630","Zona_23-Area_64-Sottoarea_127",2015,10,203,89,292
"4631","Zona_23-Area_64-Sottoarea_127",2015,11,200,95,295
"4632","Zona_23-Area_64-Sottoarea_127",2015,12,157,76,233
"4633","Zona_23-Area_64-Sottoarea_127",2016,1,176,78,254
"4634","Zona_23-Area_64-Sottoarea_127",2016,2,189,93,282
"4635","Zona_23-Area_64-Sottoarea_127",2016,3,215,105,320
"4636","Zona_23-Area_64-Sottoarea_127",2016,4,180,73,253
"4637","Zona_23-Area_64-Sottoarea_127",2016,5,118,38,156
"4638","Zona_23-Area_64-Sottoarea_127",2016,6,0,0,0
"4639","Zona_23-Area_64-Sottoarea_127",2016,7,0,0,0
"4640","Zona_23-Area_64-Sottoarea_127",2016,8,0,0,0
"4641","Zona_23-Area_64-Sottoarea_127",2016,9,0,0,0
"4642","Zona_23-Area_64-Sottoarea_127",2016,10,0,0,0
"4643","Zona_23-Area_64-Sottoarea_127",2016,11,0,0,0
"4644","Zona_23-Area_64-Sottoarea_127",2016,12,0,0,0
"4645","Zona_23-Area_64-Sottoarea_128",2014,1,30,7,37
"4646","Zona_23-Area_64-Sottoarea_128",2014,2,33,12,45
"4647","Zona_23-Area_64-Sottoarea_128",2014,3,27,8,35
"4648","Zona_23-Area_64-Sottoarea_128",2014,4,31,11,42
"4649","Zona_23-Area_64-Sottoarea_128",2014,5,32,10,42
"4650","Zona_23-Area_64-Sottoarea_128",2014,6,24,4,28
"4651","Zona_23-Area_64-Sottoarea_128",2014,7,30,8,38
"4652","Zona_23-Area_64-Sottoarea_128",2014,8,22,5,27
"4653","Zona_23-Area_64-Sottoarea_128",2014,9,31,10,41
"4654","Zona_23-Area_64-Sottoarea_128",2014,10,37,17,54
"4655","Zona_23-Area_64-Sottoarea_128",2014,11,30,23,53
"4656","Zona_23-Area_64-Sottoarea_128",2014,12,27,20,47
"4657","Zona_23-Area_64-Sottoarea_128",2015,1,30,11,41
"4658","Zona_23-Area_64-Sottoarea_128",2015,2,35,23,58
"4659","Zona_23-Area_64-Sottoarea_128",2015,3,32,17,49
"4660","Zona_23-Area_64-Sottoarea_128",2015,4,30,13,43
"4661","Zona_23-Area_64-Sottoarea_128",2015,5,27,17,44
"4662","Zona_23-Area_64-Sottoarea_128",2015,6,26,18,44
"4663","Zona_23-Area_64-Sottoarea_128",2015,7,26,15,41
"4664","Zona_23-Area_64-Sottoarea_128",2015,8,24,4,28
"4665","Zona_23-Area_64-Sottoarea_128",2015,9,41,16,57
"4666","Zona_23-Area_64-Sottoarea_128",2015,10,31,16,47
"4667","Zona_23-Area_64-Sottoarea_128",2015,11,31,21,52
"4668","Zona_23-Area_64-Sottoarea_128",2015,12,25,15,40
"4669","Zona_23-Area_64-Sottoarea_128",2016,1,33,14,47
"4670","Zona_23-Area_64-Sottoarea_128",2016,2,35,21,56
"4671","Zona_23-Area_64-Sottoarea_128",2016,3,34,20,54
"4672","Zona_23-Area_64-Sottoarea_128",2016,4,34,12,46
"4673","Zona_23-Area_64-Sottoarea_128",2016,5,23,10,33
"4674","Zona_23-Area_64-Sottoarea_128",2016,6,0,0,0
"4675","Zona_23-Area_64-Sottoarea_128",2016,7,0,0,0
"4676","Zona_23-Area_64-Sottoarea_128",2016,8,0,0,0
"4677","Zona_23-Area_64-Sottoarea_128",2016,9,0,0,0
"4678","Zona_23-Area_64-Sottoarea_128",2016,10,0,0,0
"4679","Zona_23-Area_64-Sottoarea_128",2016,11,0,0,0
"4680","Zona_23-Area_64-Sottoarea_128",2016,12,0,0,0
"4681","Zona_24-Area_65-Sottoarea_129",2014,1,195,107,302
"4682","Zona_24-Area_65-Sottoarea_129",2014,2,291,90,381
"4683","Zona_24-Area_65-Sottoarea_129",2014,3,208,73,281
"4684","Zona_24-Area_65-Sottoarea_129",2014,4,242,65,307
"4685","Zona_24-Area_65-Sottoarea_129",2014,5,256,71,327
"4686","Zona_24-Area_65-Sottoarea_129",2014,6,243,70,313
"4687","Zona_24-Area_65-Sottoarea_129",2014,7,241,63,304
"4688","Zona_24-Area_65-Sottoarea_129",2014,8,200,54,254
"4689","Zona_24-Area_65-Sottoarea_129",2014,9,236,58,294
"4690","Zona_24-Area_65-Sottoarea_129",2014,10,301,94,395
"4691","Zona_24-Area_65-Sottoarea_129",2014,11,274,77,351
"4692","Zona_24-Area_65-Sottoarea_129",2014,12,217,82,299
"4693","Zona_24-Area_65-Sottoarea_129",2015,1,222,73,295
"4694","Zona_24-Area_65-Sottoarea_129",2015,2,234,92,326
"4695","Zona_24-Area_65-Sottoarea_129",2015,3,270,178,448
"4696","Zona_24-Area_65-Sottoarea_129",2015,4,228,100,328
"4697","Zona_24-Area_65-Sottoarea_129",2015,5,228,113,341
"4698","Zona_24-Area_65-Sottoarea_129",2015,6,208,81,289
"4699","Zona_24-Area_65-Sottoarea_129",2015,7,199,88,287
"4700","Zona_24-Area_65-Sottoarea_129",2015,8,156,59,215
"4701","Zona_24-Area_65-Sottoarea_129",2015,9,230,80,310
"4702","Zona_24-Area_65-Sottoarea_129",2015,10,256,97,353
"4703","Zona_24-Area_65-Sottoarea_129",2015,11,223,100,323
"4704","Zona_24-Area_65-Sottoarea_129",2015,12,225,82,307
"4705","Zona_24-Area_65-Sottoarea_129",2016,1,231,73,304
"4706","Zona_24-Area_65-Sottoarea_129",2016,2,241,84,325
"4707","Zona_24-Area_65-Sottoarea_129",2016,3,244,106,350
"4708","Zona_24-Area_65-Sottoarea_129",2016,4,205,89,294
"4709","Zona_24-Area_65-Sottoarea_129",2016,5,139,57,196
"4710","Zona_24-Area_65-Sottoarea_129",2016,6,0,0,0
"4711","Zona_24-Area_65-Sottoarea_129",2016,7,0,0,0
"4712","Zona_24-Area_65-Sottoarea_129",2016,8,0,0,0
"4713","Zona_24-Area_65-Sottoarea_129",2016,9,0,0,0
"4714","Zona_24-Area_65-Sottoarea_129",2016,10,0,0,0
"4715","Zona_24-Area_65-Sottoarea_129",2016,11,0,0,0
"4716","Zona_24-Area_65-Sottoarea_129",2016,12,0,0,0
"4717","Zona_24-Area_66-Sottoarea_130",2014,1,134,66,200
"4718","Zona_24-Area_66-Sottoarea_130",2014,2,189,71,260
"4719","Zona_24-Area_66-Sottoarea_130",2014,3,125,65,190
"4720","Zona_24-Area_66-Sottoarea_130",2014,4,156,73,229
"4721","Zona_24-Area_66-Sottoarea_130",2014,5,162,69,231
"4722","Zona_24-Area_66-Sottoarea_130",2014,6,145,58,203
"4723","Zona_24-Area_66-Sottoarea_130",2014,7,139,59,198
"4724","Zona_24-Area_66-Sottoarea_130",2014,8,124,52,176
"4725","Zona_24-Area_66-Sottoarea_130",2014,9,147,53,200
"4726","Zona_24-Area_66-Sottoarea_130",2014,10,200,73,273
"4727","Zona_24-Area_66-Sottoarea_130",2014,11,172,80,252
"4728","Zona_24-Area_66-Sottoarea_130",2014,12,174,65,239
"4729","Zona_24-Area_66-Sottoarea_130",2015,1,179,60,239
"4730","Zona_24-Area_66-Sottoarea_130",2015,2,184,79,263
"4731","Zona_24-Area_66-Sottoarea_130",2015,3,203,108,311
"4732","Zona_24-Area_66-Sottoarea_130",2015,4,185,90,275
"4733","Zona_24-Area_66-Sottoarea_130",2015,5,168,87,255
"4734","Zona_24-Area_66-Sottoarea_130",2015,6,198,70,268
"4735","Zona_24-Area_66-Sottoarea_130",2015,7,184,73,257
"4736","Zona_24-Area_66-Sottoarea_130",2015,8,142,50,192
"4737","Zona_24-Area_66-Sottoarea_130",2015,9,195,75,270
"4738","Zona_24-Area_66-Sottoarea_130",2015,10,234,83,317
"4739","Zona_24-Area_66-Sottoarea_130",2015,11,220,78,298
"4740","Zona_24-Area_66-Sottoarea_130",2015,12,200,66,266
"4741","Zona_24-Area_66-Sottoarea_130",2016,1,210,71,281
"4742","Zona_24-Area_66-Sottoarea_130",2016,2,223,89,312
"4743","Zona_24-Area_66-Sottoarea_130",2016,3,239,106,345
"4744","Zona_24-Area_66-Sottoarea_130",2016,4,211,78,289
"4745","Zona_24-Area_66-Sottoarea_130",2016,5,128,52,180
"4746","Zona_24-Area_66-Sottoarea_130",2016,6,0,0,0
"4747","Zona_24-Area_66-Sottoarea_130",2016,7,0,0,0
"4748","Zona_24-Area_66-Sottoarea_130",2016,8,0,0,0
"4749","Zona_24-Area_66-Sottoarea_130",2016,9,0,0,0
"4750","Zona_24-Area_66-Sottoarea_130",2016,10,0,0,0
"4751","Zona_24-Area_66-Sottoarea_130",2016,11,0,0,0
"4752","Zona_24-Area_66-Sottoarea_130",2016,12,0,0,0
"4753","Zona_24-Area_67-Sottoarea_131",2014,1,130,64,194
"4754","Zona_24-Area_67-Sottoarea_131",2014,2,140,76,216
"4755","Zona_24-Area_67-Sottoarea_131",2014,3,134,66,200
"4756","Zona_24-Area_67-Sottoarea_131",2014,4,142,67,209
"4757","Zona_24-Area_67-Sottoarea_131",2014,5,161,69,230
"4758","Zona_24-Area_67-Sottoarea_131",2014,6,141,60,201
"4759","Zona_24-Area_67-Sottoarea_131",2014,7,153,69,222
"4760","Zona_24-Area_67-Sottoarea_131",2014,8,116,43,159
"4761","Zona_24-Area_67-Sottoarea_131",2014,9,140,46,186
"4762","Zona_24-Area_67-Sottoarea_131",2014,10,186,82,268
"4763","Zona_24-Area_67-Sottoarea_131",2014,11,157,93,250
"4764","Zona_24-Area_67-Sottoarea_131",2014,12,174,83,257
"4765","Zona_24-Area_67-Sottoarea_131",2015,1,179,84,263
"4766","Zona_24-Area_67-Sottoarea_131",2015,2,181,100,281
"4767","Zona_24-Area_67-Sottoarea_131",2015,3,190,118,308
"4768","Zona_24-Area_67-Sottoarea_131",2015,4,176,92,268
"4769","Zona_24-Area_67-Sottoarea_131",2015,5,173,89,262
"4770","Zona_24-Area_67-Sottoarea_131",2015,6,168,83,251
"4771","Zona_24-Area_67-Sottoarea_131",2015,7,161,83,244
"4772","Zona_24-Area_67-Sottoarea_131",2015,8,118,48,166
"4773","Zona_24-Area_67-Sottoarea_131",2015,9,173,89,262
"4774","Zona_24-Area_67-Sottoarea_131",2015,10,197,101,298
"4775","Zona_24-Area_67-Sottoarea_131",2015,11,180,98,278
"4776","Zona_24-Area_67-Sottoarea_131",2015,12,169,73,242
"4777","Zona_24-Area_67-Sottoarea_131",2016,1,183,67,250
"4778","Zona_24-Area_67-Sottoarea_131",2016,2,211,89,300
"4779","Zona_24-Area_67-Sottoarea_131",2016,3,222,100,322
"4780","Zona_24-Area_67-Sottoarea_131",2016,4,208,90,298
"4781","Zona_24-Area_67-Sottoarea_131",2016,5,125,74,199
"4782","Zona_24-Area_67-Sottoarea_131",2016,6,0,0,0
"4783","Zona_24-Area_67-Sottoarea_131",2016,7,0,0,0
"4784","Zona_24-Area_67-Sottoarea_131",2016,8,0,0,0
"4785","Zona_24-Area_67-Sottoarea_131",2016,9,0,0,0
"4786","Zona_24-Area_67-Sottoarea_131",2016,10,0,0,0
"4787","Zona_24-Area_67-Sottoarea_131",2016,11,0,0,0
"4788","Zona_24-Area_67-Sottoarea_131",2016,12,0,0,0
"4789","Zona_25-Area_60-Sottoarea_26",2014,1,122,61,183
"4790","Zona_25-Area_60-Sottoarea_26",2014,2,116,64,180
"4791","Zona_25-Area_60-Sottoarea_26",2014,3,91,55,146
"4792","Zona_25-Area_60-Sottoarea_26",2014,4,117,58,175
"4793","Zona_25-Area_60-Sottoarea_26",2014,5,121,59,180
"4794","Zona_25-Area_60-Sottoarea_26",2014,6,110,53,163
"4795","Zona_25-Area_60-Sottoarea_26",2014,7,128,52,180
"4796","Zona_25-Area_60-Sottoarea_26",2014,8,95,48,143
"4797","Zona_25-Area_60-Sottoarea_26",2014,9,124,57,181
"4798","Zona_25-Area_60-Sottoarea_26",2014,10,151,79,230
"4799","Zona_25-Area_60-Sottoarea_26",2014,11,132,73,205
"4800","Zona_25-Area_60-Sottoarea_26",2014,12,135,86,221
"4801","Zona_25-Area_60-Sottoarea_26",2015,1,134,86,220
"4802","Zona_25-Area_60-Sottoarea_26",2015,2,134,92,226
"4803","Zona_25-Area_60-Sottoarea_26",2015,3,147,96,243
"4804","Zona_25-Area_60-Sottoarea_26",2015,4,124,86,210
"4805","Zona_25-Area_60-Sottoarea_26",2015,5,116,84,200
"4806","Zona_25-Area_60-Sottoarea_26",2015,6,133,78,211
"4807","Zona_25-Area_60-Sottoarea_26",2015,7,132,106,238
"4808","Zona_25-Area_60-Sottoarea_26",2015,8,103,57,160
"4809","Zona_25-Area_60-Sottoarea_26",2015,9,169,66,235
"4810","Zona_25-Area_60-Sottoarea_26",2015,10,189,93,282
"4811","Zona_25-Area_60-Sottoarea_26",2015,11,162,146,308
"4812","Zona_25-Area_60-Sottoarea_26",2015,12,143,80,223
"4813","Zona_25-Area_60-Sottoarea_26",2016,1,152,98,250
"4814","Zona_25-Area_60-Sottoarea_26",2016,2,183,114,297
"4815","Zona_25-Area_60-Sottoarea_26",2016,3,192,100,292
"4816","Zona_25-Area_60-Sottoarea_26",2016,4,162,71,233
"4817","Zona_25-Area_60-Sottoarea_26",2016,5,97,39,136
"4818","Zona_25-Area_60-Sottoarea_26",2016,6,0,0,0
"4819","Zona_25-Area_60-Sottoarea_26",2016,7,0,0,0
"4820","Zona_25-Area_60-Sottoarea_26",2016,8,0,0,0
"4821","Zona_25-Area_60-Sottoarea_26",2016,9,0,0,0
"4822","Zona_25-Area_60-Sottoarea_26",2016,10,0,0,0
"4823","Zona_25-Area_60-Sottoarea_26",2016,11,0,0,0
"4824","Zona_25-Area_60-Sottoarea_26",2016,12,0,0,0
"4825","Zona_25-Area_60-Sottoarea_27",2014,1,116,39,155
"4826","Zona_25-Area_60-Sottoarea_27",2014,2,111,50,161
"4827","Zona_25-Area_60-Sottoarea_27",2014,3,88,42,130
"4828","Zona_25-Area_60-Sottoarea_27",2014,4,105,45,150
"4829","Zona_25-Area_60-Sottoarea_27",2014,5,115,42,157
"4830","Zona_25-Area_60-Sottoarea_27",2014,6,107,40,147
"4831","Zona_25-Area_60-Sottoarea_27",2014,7,128,45,173
"4832","Zona_25-Area_60-Sottoarea_27",2014,8,103,39,142
"4833","Zona_25-Area_60-Sottoarea_27",2014,9,130,48,178
"4834","Zona_25-Area_60-Sottoarea_27",2014,10,156,66,222
"4835","Zona_25-Area_60-Sottoarea_27",2014,11,129,57,186
"4836","Zona_25-Area_60-Sottoarea_27",2014,12,136,48,184
"4837","Zona_25-Area_60-Sottoarea_27",2015,1,142,62,204
"4838","Zona_25-Area_60-Sottoarea_27",2015,2,129,65,194
"4839","Zona_25-Area_60-Sottoarea_27",2015,3,145,65,210
"4840","Zona_25-Area_60-Sottoarea_27",2015,4,115,67,182
"4841","Zona_25-Area_60-Sottoarea_27",2015,5,111,61,172
"4842","Zona_25-Area_60-Sottoarea_27",2015,6,125,61,186
"4843","Zona_25-Area_60-Sottoarea_27",2015,7,122,86,208
"4844","Zona_25-Area_60-Sottoarea_27",2015,8,104,41,145
"4845","Zona_25-Area_60-Sottoarea_27",2015,9,149,44,193
"4846","Zona_25-Area_60-Sottoarea_27",2015,10,143,62,205
"4847","Zona_25-Area_60-Sottoarea_27",2015,11,151,58,209
"4848","Zona_25-Area_60-Sottoarea_27",2015,12,139,44,183
"4849","Zona_25-Area_60-Sottoarea_27",2016,1,137,51,188
"4850","Zona_25-Area_60-Sottoarea_27",2016,2,143,56,199
"4851","Zona_25-Area_60-Sottoarea_27",2016,3,155,60,215
"4852","Zona_25-Area_60-Sottoarea_27",2016,4,132,45,177
"4853","Zona_25-Area_60-Sottoarea_27",2016,5,83,33,116
"4854","Zona_25-Area_60-Sottoarea_27",2016,6,0,0,0
"4855","Zona_25-Area_60-Sottoarea_27",2016,7,0,0,0
"4856","Zona_25-Area_60-Sottoarea_27",2016,8,0,0,0
"4857","Zona_25-Area_60-Sottoarea_27",2016,9,0,0,0
"4858","Zona_25-Area_60-Sottoarea_27",2016,10,0,0,0
"4859","Zona_25-Area_60-Sottoarea_27",2016,11,0,0,0
"4860","Zona_25-Area_60-Sottoarea_27",2016,12,0,0,0
"4861","Zona_25-Area_61-Sottoarea_144",2014,1,222,111,333
"4862","Zona_25-Area_61-Sottoarea_144",2014,2,287,122,409
"4863","Zona_25-Area_61-Sottoarea_144",2014,3,238,76,314
"4864","Zona_25-Area_61-Sottoarea_144",2014,4,261,91,352
"4865","Zona_25-Area_61-Sottoarea_144",2014,5,242,82,324
"4866","Zona_25-Area_61-Sottoarea_144",2014,6,268,77,345
"4867","Zona_25-Area_61-Sottoarea_144",2014,7,281,91,372
"4868","Zona_25-Area_61-Sottoarea_144",2014,8,202,66,268
"4869","Zona_25-Area_61-Sottoarea_144",2014,9,262,66,328
"4870","Zona_25-Area_61-Sottoarea_144",2014,10,298,102,400
"4871","Zona_25-Area_61-Sottoarea_144",2014,11,271,99,370
"4872","Zona_25-Area_61-Sottoarea_144",2014,12,273,105,378
"4873","Zona_25-Area_61-Sottoarea_144",2015,1,243,152,395
"4874","Zona_25-Area_61-Sottoarea_144",2015,2,259,167,426
"4875","Zona_25-Area_61-Sottoarea_144",2015,3,274,158,432
"4876","Zona_25-Area_61-Sottoarea_144",2015,4,250,128,378
"4877","Zona_25-Area_61-Sottoarea_144",2015,5,233,131,364
"4878","Zona_25-Area_61-Sottoarea_144",2015,6,256,137,393
"4879","Zona_25-Area_61-Sottoarea_144",2015,7,251,161,412
"4880","Zona_25-Area_61-Sottoarea_144",2015,8,186,87,273
"4881","Zona_25-Area_61-Sottoarea_144",2015,9,286,109,395
"4882","Zona_25-Area_61-Sottoarea_144",2015,10,300,135,435
"4883","Zona_25-Area_61-Sottoarea_144",2015,11,287,133,420
"4884","Zona_25-Area_61-Sottoarea_144",2015,12,252,115,367
"4885","Zona_25-Area_61-Sottoarea_144",2016,1,278,111,389
"4886","Zona_25-Area_61-Sottoarea_144",2016,2,324,139,463
"4887","Zona_25-Area_61-Sottoarea_144",2016,3,360,161,521
"4888","Zona_25-Area_61-Sottoarea_144",2016,4,383,111,494
"4889","Zona_25-Area_61-Sottoarea_144",2016,5,234,65,299
"4890","Zona_25-Area_61-Sottoarea_144",2016,6,0,0,0
"4891","Zona_25-Area_61-Sottoarea_144",2016,7,0,0,0
"4892","Zona_25-Area_61-Sottoarea_144",2016,8,0,0,0
"4893","Zona_25-Area_61-Sottoarea_144",2016,9,0,0,0
"4894","Zona_25-Area_61-Sottoarea_144",2016,10,0,0,0
"4895","Zona_25-Area_61-Sottoarea_144",2016,11,0,0,0
"4896","Zona_25-Area_61-Sottoarea_144",2016,12,0,0,0
"4897","Zona_26-Area_71-Sottoarea_98",2014,1,77,37,114
"4898","Zona_26-Area_71-Sottoarea_98",2014,2,80,41,121
"4899","Zona_26-Area_71-Sottoarea_98",2014,3,67,39,106
"4900","Zona_26-Area_71-Sottoarea_98",2014,4,73,41,114
"4901","Zona_26-Area_71-Sottoarea_98",2014,5,76,44,120
"4902","Zona_26-Area_71-Sottoarea_98",2014,6,81,36,117
"4903","Zona_26-Area_71-Sottoarea_98",2014,7,84,39,123
"4904","Zona_26-Area_71-Sottoarea_98",2014,8,54,32,86
"4905","Zona_26-Area_71-Sottoarea_98",2014,9,84,32,116
"4906","Zona_26-Area_71-Sottoarea_98",2014,10,104,56,160
"4907","Zona_26-Area_71-Sottoarea_98",2014,11,78,43,121
"4908","Zona_26-Area_71-Sottoarea_98",2014,12,77,43,120
"4909","Zona_26-Area_71-Sottoarea_98",2015,1,74,53,127
"4910","Zona_26-Area_71-Sottoarea_98",2015,2,86,52,138
"4911","Zona_26-Area_71-Sottoarea_98",2015,3,94,64,158
"4912","Zona_26-Area_71-Sottoarea_98",2015,4,84,48,132
"4913","Zona_26-Area_71-Sottoarea_98",2015,5,81,48,129
"4914","Zona_26-Area_71-Sottoarea_98",2015,6,93,38,131
"4915","Zona_26-Area_71-Sottoarea_98",2015,7,90,36,126
"4916","Zona_26-Area_71-Sottoarea_98",2015,8,85,32,117
"4917","Zona_26-Area_71-Sottoarea_98",2015,9,111,33,144
"4918","Zona_26-Area_71-Sottoarea_98",2015,10,115,45,160
"4919","Zona_26-Area_71-Sottoarea_98",2015,11,117,41,158
"4920","Zona_26-Area_71-Sottoarea_98",2015,12,103,35,138
"4921","Zona_26-Area_71-Sottoarea_98",2016,1,101,38,139
"4922","Zona_26-Area_71-Sottoarea_98",2016,2,124,39,163
"4923","Zona_26-Area_71-Sottoarea_98",2016,3,120,49,169
"4924","Zona_26-Area_71-Sottoarea_98",2016,4,104,36,140
"4925","Zona_26-Area_71-Sottoarea_98",2016,5,63,22,85
"4926","Zona_26-Area_71-Sottoarea_98",2016,6,0,0,0
"4927","Zona_26-Area_71-Sottoarea_98",2016,7,0,0,0
"4928","Zona_26-Area_71-Sottoarea_98",2016,8,0,0,0
"4929","Zona_26-Area_71-Sottoarea_98",2016,9,0,0,0
"4930","Zona_26-Area_71-Sottoarea_98",2016,10,0,0,0
"4931","Zona_26-Area_71-Sottoarea_98",2016,11,0,0,0
"4932","Zona_26-Area_71-Sottoarea_98",2016,12,0,0,0
"4933","Zona_26-Area_71-Sottoarea_99",2014,1,117,51,168
"4934","Zona_26-Area_71-Sottoarea_99",2014,2,127,56,183
"4935","Zona_26-Area_71-Sottoarea_99",2014,3,101,44,145
"4936","Zona_26-Area_71-Sottoarea_99",2014,4,112,47,159
"4937","Zona_26-Area_71-Sottoarea_99",2014,5,129,47,176
"4938","Zona_26-Area_71-Sottoarea_99",2014,6,122,41,163
"4939","Zona_26-Area_71-Sottoarea_99",2014,7,109,47,156
"4940","Zona_26-Area_71-Sottoarea_99",2014,8,87,36,123
"4941","Zona_26-Area_71-Sottoarea_99",2014,9,120,44,164
"4942","Zona_26-Area_71-Sottoarea_99",2014,10,168,51,219
"4943","Zona_26-Area_71-Sottoarea_99",2014,11,107,46,153
"4944","Zona_26-Area_71-Sottoarea_99",2014,12,133,65,198
"4945","Zona_26-Area_71-Sottoarea_99",2015,1,120,77,197
"4946","Zona_26-Area_71-Sottoarea_99",2015,2,142,61,203
"4947","Zona_26-Area_71-Sottoarea_99",2015,3,159,77,236
"4948","Zona_26-Area_71-Sottoarea_99",2015,4,142,59,201
"4949","Zona_26-Area_71-Sottoarea_99",2015,5,126,55,181
"4950","Zona_26-Area_71-Sottoarea_99",2015,6,130,52,182
"4951","Zona_26-Area_71-Sottoarea_99",2015,7,138,53,191
"4952","Zona_26-Area_71-Sottoarea_99",2015,8,105,40,145
"4953","Zona_26-Area_71-Sottoarea_99",2015,9,145,49,194
"4954","Zona_26-Area_71-Sottoarea_99",2015,10,172,50,222
"4955","Zona_26-Area_71-Sottoarea_99",2015,11,141,56,197
"4956","Zona_26-Area_71-Sottoarea_99",2015,12,125,48,173
"4957","Zona_26-Area_71-Sottoarea_99",2016,1,129,49,178
"4958","Zona_26-Area_71-Sottoarea_99",2016,2,150,55,205
"4959","Zona_26-Area_71-Sottoarea_99",2016,3,164,59,223
"4960","Zona_26-Area_71-Sottoarea_99",2016,4,153,47,200
"4961","Zona_26-Area_71-Sottoarea_99",2016,5,82,29,111
"4962","Zona_26-Area_71-Sottoarea_99",2016,6,0,0,0
"4963","Zona_26-Area_71-Sottoarea_99",2016,7,0,0,0
"4964","Zona_26-Area_71-Sottoarea_99",2016,8,0,0,0
"4965","Zona_26-Area_71-Sottoarea_99",2016,9,0,0,0
"4966","Zona_26-Area_71-Sottoarea_99",2016,10,0,0,0
"4967","Zona_26-Area_71-Sottoarea_99",2016,11,0,0,0
"4968","Zona_26-Area_71-Sottoarea_99",2016,12,0,0,0
"4969","Zona_27-Area_72-Sottoarea_92",2014,1,157,78,235
"4970","Zona_27-Area_72-Sottoarea_92",2014,2,176,98,274
"4971","Zona_27-Area_72-Sottoarea_92",2014,3,139,97,236
"4972","Zona_27-Area_72-Sottoarea_92",2014,4,169,95,264
"4973","Zona_27-Area_72-Sottoarea_92",2014,5,170,85,255
"4974","Zona_27-Area_72-Sottoarea_92",2014,6,173,80,253
"4975","Zona_27-Area_72-Sottoarea_92",2014,7,177,71,248
"4976","Zona_27-Area_72-Sottoarea_92",2014,8,111,57,168
"4977","Zona_27-Area_72-Sottoarea_92",2014,9,199,63,262
"4978","Zona_27-Area_72-Sottoarea_92",2014,10,223,79,302
"4979","Zona_27-Area_72-Sottoarea_92",2014,11,197,86,283
"4980","Zona_27-Area_72-Sottoarea_92",2014,12,154,71,225
"4981","Zona_27-Area_72-Sottoarea_92",2015,1,168,99,267
"4982","Zona_27-Area_72-Sottoarea_92",2015,2,171,96,267
"4983","Zona_27-Area_72-Sottoarea_92",2015,3,194,112,306
"4984","Zona_27-Area_72-Sottoarea_92",2015,4,162,86,248
"4985","Zona_27-Area_72-Sottoarea_92",2015,5,158,85,243
"4986","Zona_27-Area_72-Sottoarea_92",2015,6,158,90,248
"4987","Zona_27-Area_72-Sottoarea_92",2015,7,151,100,251
"4988","Zona_27-Area_72-Sottoarea_92",2015,8,131,64,195
"4989","Zona_27-Area_72-Sottoarea_92",2015,9,184,83,267
"4990","Zona_27-Area_72-Sottoarea_92",2015,10,222,88,310
"4991","Zona_27-Area_72-Sottoarea_92",2015,11,196,85,281
"4992","Zona_27-Area_72-Sottoarea_92",2015,12,167,64,231
"4993","Zona_27-Area_72-Sottoarea_92",2016,1,180,73,253
"4994","Zona_27-Area_72-Sottoarea_92",2016,2,212,91,303
"4995","Zona_27-Area_72-Sottoarea_92",2016,3,229,110,339
"4996","Zona_27-Area_72-Sottoarea_92",2016,4,200,88,288
"4997","Zona_27-Area_72-Sottoarea_92",2016,5,123,50,173
"4998","Zona_27-Area_72-Sottoarea_92",2016,6,0,0,0
"4999","Zona_27-Area_72-Sottoarea_92",2016,7,0,0,0
"5000","Zona_27-Area_72-Sottoarea_92",2016,8,0,0,0
"5001","Zona_27-Area_72-Sottoarea_92",2016,9,0,0,0
"5002","Zona_27-Area_72-Sottoarea_92",2016,10,0,0,0
"5003","Zona_27-Area_72-Sottoarea_92",2016,11,0,0,0
"5004","Zona_27-Area_72-Sottoarea_92",2016,12,0,0,0
"5005","Zona_27-Area_72-Sottoarea_93",2014,1,56,31,87
"5006","Zona_27-Area_72-Sottoarea_93",2014,2,58,36,94
"5007","Zona_27-Area_72-Sottoarea_93",2014,3,49,34,83
"5008","Zona_27-Area_72-Sottoarea_93",2014,4,63,38,101
"5009","Zona_27-Area_72-Sottoarea_93",2014,5,53,29,82
"5010","Zona_27-Area_72-Sottoarea_93",2014,6,55,32,87
"5011","Zona_27-Area_72-Sottoarea_93",2014,7,59,30,89
"5012","Zona_27-Area_72-Sottoarea_93",2014,8,37,22,59
"5013","Zona_27-Area_72-Sottoarea_93",2014,9,64,27,91
"5014","Zona_27-Area_72-Sottoarea_93",2014,10,65,34,99
"5015","Zona_27-Area_72-Sottoarea_93",2014,11,62,32,94
"5016","Zona_27-Area_72-Sottoarea_93",2014,12,52,32,84
"5017","Zona_27-Area_72-Sottoarea_93",2015,1,58,34,92
"5018","Zona_27-Area_72-Sottoarea_93",2015,2,60,45,105
"5019","Zona_27-Area_72-Sottoarea_93",2015,3,62,42,104
"5020","Zona_27-Area_72-Sottoarea_93",2015,4,50,35,85
"5021","Zona_27-Area_72-Sottoarea_93",2015,5,61,34,95
"5022","Zona_27-Area_72-Sottoarea_93",2015,6,53,26,79
"5023","Zona_27-Area_72-Sottoarea_93",2015,7,54,36,90
"5024","Zona_27-Area_72-Sottoarea_93",2015,8,50,24,74
"5025","Zona_27-Area_72-Sottoarea_93",2015,9,58,24,82
"5026","Zona_27-Area_72-Sottoarea_93",2015,10,75,41,116
"5027","Zona_27-Area_72-Sottoarea_93",2015,11,60,31,91
"5028","Zona_27-Area_72-Sottoarea_93",2015,12,53,24,77
"5029","Zona_27-Area_72-Sottoarea_93",2016,1,57,26,83
"5030","Zona_27-Area_72-Sottoarea_93",2016,2,73,42,115
"5031","Zona_27-Area_72-Sottoarea_93",2016,3,75,53,128
"5032","Zona_27-Area_72-Sottoarea_93",2016,4,59,30,89
"5033","Zona_27-Area_72-Sottoarea_93",2016,5,44,19,63
"5034","Zona_27-Area_72-Sottoarea_93",2016,6,0,0,0
"5035","Zona_27-Area_72-Sottoarea_93",2016,7,0,0,0
"5036","Zona_27-Area_72-Sottoarea_93",2016,8,0,0,0
"5037","Zona_27-Area_72-Sottoarea_93",2016,9,0,0,0
"5038","Zona_27-Area_72-Sottoarea_93",2016,10,0,0,0
"5039","Zona_27-Area_72-Sottoarea_93",2016,11,0,0,0
"5040","Zona_27-Area_72-Sottoarea_93",2016,12,0,0,0
"5041","Zona_27-Area_73-Sottoarea_141",2014,1,54,22,76
"5042","Zona_27-Area_73-Sottoarea_141",2014,2,62,28,90
"5043","Zona_27-Area_73-Sottoarea_141",2014,3,42,21,63
"5044","Zona_27-Area_73-Sottoarea_141",2014,4,51,23,74
"5045","Zona_27-Area_73-Sottoarea_141",2014,5,52,22,74
"5046","Zona_27-Area_73-Sottoarea_141",2014,6,52,19,71
"5047","Zona_27-Area_73-Sottoarea_141",2014,7,57,23,80
"5048","Zona_27-Area_73-Sottoarea_141",2014,8,41,20,61
"5049","Zona_27-Area_73-Sottoarea_141",2014,9,61,22,83
"5050","Zona_27-Area_73-Sottoarea_141",2014,10,60,32,92
"5051","Zona_27-Area_73-Sottoarea_141",2014,11,63,28,91
"5052","Zona_27-Area_73-Sottoarea_141",2014,12,60,30,90
"5053","Zona_27-Area_73-Sottoarea_141",2015,1,62,33,95
"5054","Zona_27-Area_73-Sottoarea_141",2015,2,60,34,94
"5055","Zona_27-Area_73-Sottoarea_141",2015,3,71,41,112
"5056","Zona_27-Area_73-Sottoarea_141",2015,4,56,44,100
"5057","Zona_27-Area_73-Sottoarea_141",2015,5,56,47,103
"5058","Zona_27-Area_73-Sottoarea_141",2015,6,53,39,92
"5059","Zona_27-Area_73-Sottoarea_141",2015,7,51,48,99
"5060","Zona_27-Area_73-Sottoarea_141",2015,8,48,25,73
"5061","Zona_27-Area_73-Sottoarea_141",2015,9,58,32,90
"5062","Zona_27-Area_73-Sottoarea_141",2015,10,70,38,108
"5063","Zona_27-Area_73-Sottoarea_141",2015,11,66,32,98
"5064","Zona_27-Area_73-Sottoarea_141",2015,12,58,30,88
"5065","Zona_27-Area_73-Sottoarea_141",2016,1,78,43,121
"5066","Zona_27-Area_73-Sottoarea_141",2016,2,75,39,114
"5067","Zona_27-Area_73-Sottoarea_141",2016,3,86,43,129
"5068","Zona_27-Area_73-Sottoarea_141",2016,4,90,31,121
"5069","Zona_27-Area_73-Sottoarea_141",2016,5,52,17,69
"5070","Zona_27-Area_73-Sottoarea_141",2016,6,0,0,0
"5071","Zona_27-Area_73-Sottoarea_141",2016,7,0,0,0
"5072","Zona_27-Area_73-Sottoarea_141",2016,8,0,0,0
"5073","Zona_27-Area_73-Sottoarea_141",2016,9,0,0,0
"5074","Zona_27-Area_73-Sottoarea_141",2016,10,0,0,0
"5075","Zona_27-Area_73-Sottoarea_141",2016,11,0,0,0
"5076","Zona_27-Area_73-Sottoarea_141",2016,12,0,0,0
"5077","Zona_27-Area_73-Sottoarea_142",2014,1,123,71,194
"5078","Zona_27-Area_73-Sottoarea_142",2014,2,139,73,212
"5079","Zona_27-Area_73-Sottoarea_142",2014,3,100,59,159
"5080","Zona_27-Area_73-Sottoarea_142",2014,4,144,59,203
"5081","Zona_27-Area_73-Sottoarea_142",2014,5,142,63,205
"5082","Zona_27-Area_73-Sottoarea_142",2014,6,144,61,205
"5083","Zona_27-Area_73-Sottoarea_142",2014,7,145,79,224
"5084","Zona_27-Area_73-Sottoarea_142",2014,8,100,63,163
"5085","Zona_27-Area_73-Sottoarea_142",2014,9,143,64,207
"5086","Zona_27-Area_73-Sottoarea_142",2014,10,152,91,243
"5087","Zona_27-Area_73-Sottoarea_142",2014,11,151,89,240
"5088","Zona_27-Area_73-Sottoarea_142",2014,12,138,76,214
"5089","Zona_27-Area_73-Sottoarea_142",2015,1,136,73,209
"5090","Zona_27-Area_73-Sottoarea_142",2015,2,146,98,244
"5091","Zona_27-Area_73-Sottoarea_142",2015,3,168,108,276
"5092","Zona_27-Area_73-Sottoarea_142",2015,4,144,89,233
"5093","Zona_27-Area_73-Sottoarea_142",2015,5,145,82,227
"5094","Zona_27-Area_73-Sottoarea_142",2015,6,144,87,231
"5095","Zona_27-Area_73-Sottoarea_142",2015,7,137,75,212
"5096","Zona_27-Area_73-Sottoarea_142",2015,8,105,51,156
"5097","Zona_27-Area_73-Sottoarea_142",2015,9,141,66,207
"5098","Zona_27-Area_73-Sottoarea_142",2015,10,166,82,248
"5099","Zona_27-Area_73-Sottoarea_142",2015,11,150,67,217
"5100","Zona_27-Area_73-Sottoarea_142",2015,12,131,62,193
"5101","Zona_27-Area_73-Sottoarea_142",2016,1,140,60,200
"5102","Zona_27-Area_73-Sottoarea_142",2016,2,162,82,244
"5103","Zona_27-Area_73-Sottoarea_142",2016,3,181,101,282
"5104","Zona_27-Area_73-Sottoarea_142",2016,4,166,77,243
"5105","Zona_27-Area_73-Sottoarea_142",2016,5,94,48,142
"5106","Zona_27-Area_73-Sottoarea_142",2016,6,0,0,0
"5107","Zona_27-Area_73-Sottoarea_142",2016,7,0,0,0
"5108","Zona_27-Area_73-Sottoarea_142",2016,8,0,0,0
"5109","Zona_27-Area_73-Sottoarea_142",2016,9,0,0,0
"5110","Zona_27-Area_73-Sottoarea_142",2016,10,0,0,0
"5111","Zona_27-Area_73-Sottoarea_142",2016,11,0,0,0
"5112","Zona_27-Area_73-Sottoarea_142",2016,12,0,0,0
"5113","Zona_27-Area_73-Sottoarea_143",2014,1,41,21,62
"5114","Zona_27-Area_73-Sottoarea_143",2014,2,47,26,73
"5115","Zona_27-Area_73-Sottoarea_143",2014,3,39,20,59
"5116","Zona_27-Area_73-Sottoarea_143",2014,4,52,24,76
"5117","Zona_27-Area_73-Sottoarea_143",2014,5,65,24,89
"5118","Zona_27-Area_73-Sottoarea_143",2014,6,54,24,78
"5119","Zona_27-Area_73-Sottoarea_143",2014,7,53,24,77
"5120","Zona_27-Area_73-Sottoarea_143",2014,8,42,17,59
"5121","Zona_27-Area_73-Sottoarea_143",2014,9,56,19,75
"5122","Zona_27-Area_73-Sottoarea_143",2014,10,65,28,93
"5123","Zona_27-Area_73-Sottoarea_143",2014,11,59,21,80
"5124","Zona_27-Area_73-Sottoarea_143",2014,12,50,25,75
"5125","Zona_27-Area_73-Sottoarea_143",2015,1,53,26,79
"5126","Zona_27-Area_73-Sottoarea_143",2015,2,58,39,97
"5127","Zona_27-Area_73-Sottoarea_143",2015,3,78,34,112
"5128","Zona_27-Area_73-Sottoarea_143",2015,4,62,35,97
"5129","Zona_27-Area_73-Sottoarea_143",2015,5,58,32,90
"5130","Zona_27-Area_73-Sottoarea_143",2015,6,64,27,91
"5131","Zona_27-Area_73-Sottoarea_143",2015,7,63,31,94
"5132","Zona_27-Area_73-Sottoarea_143",2015,8,52,20,72
"5133","Zona_27-Area_73-Sottoarea_143",2015,9,69,26,95
"5134","Zona_27-Area_73-Sottoarea_143",2015,10,81,24,105
"5135","Zona_27-Area_73-Sottoarea_143",2015,11,72,26,98
"5136","Zona_27-Area_73-Sottoarea_143",2015,12,57,20,77
"5137","Zona_27-Area_73-Sottoarea_143",2016,1,61,21,82
"5138","Zona_27-Area_73-Sottoarea_143",2016,2,67,24,91
"5139","Zona_27-Area_73-Sottoarea_143",2016,3,69,24,93
"5140","Zona_27-Area_73-Sottoarea_143",2016,4,65,22,87
"5141","Zona_27-Area_73-Sottoarea_143",2016,5,44,16,60
"5142","Zona_27-Area_73-Sottoarea_143",2016,6,0,0,0
"5143","Zona_27-Area_73-Sottoarea_143",2016,7,0,0,0
"5144","Zona_27-Area_73-Sottoarea_143",2016,8,0,0,0
"5145","Zona_27-Area_73-Sottoarea_143",2016,9,0,0,0
"5146","Zona_27-Area_73-Sottoarea_143",2016,10,0,0,0
"5147","Zona_27-Area_73-Sottoarea_143",2016,11,0,0,0
"5148","Zona_27-Area_73-Sottoarea_143",2016,12,0,0,0
"5149","Zona_27-Area_74-Sottoarea_145",2014,1,158,88,246
"5150","Zona_27-Area_74-Sottoarea_145",2014,2,215,98,313
"5151","Zona_27-Area_74-Sottoarea_145",2014,3,172,76,248
"5152","Zona_27-Area_74-Sottoarea_145",2014,4,179,85,264
"5153","Zona_27-Area_74-Sottoarea_145",2014,5,185,87,272
"5154","Zona_27-Area_74-Sottoarea_145",2014,6,181,73,254
"5155","Zona_27-Area_74-Sottoarea_145",2014,7,194,85,279
"5156","Zona_27-Area_74-Sottoarea_145",2014,8,131,67,198
"5157","Zona_27-Area_74-Sottoarea_145",2014,9,201,68,269
"5158","Zona_27-Area_74-Sottoarea_145",2014,10,207,111,318
"5159","Zona_27-Area_74-Sottoarea_145",2014,11,198,94,292
"5160","Zona_27-Area_74-Sottoarea_145",2014,12,195,93,288
"5161","Zona_27-Area_74-Sottoarea_145",2015,1,211,90,301
"5162","Zona_27-Area_74-Sottoarea_145",2015,2,211,159,370
"5163","Zona_27-Area_74-Sottoarea_145",2015,3,212,142,354
"5164","Zona_27-Area_74-Sottoarea_145",2015,4,205,115,320
"5165","Zona_27-Area_74-Sottoarea_145",2015,5,208,115,323
"5166","Zona_27-Area_74-Sottoarea_145",2015,6,209,112,321
"5167","Zona_27-Area_74-Sottoarea_145",2015,7,208,129,337
"5168","Zona_27-Area_74-Sottoarea_145",2015,8,165,74,239
"5169","Zona_27-Area_74-Sottoarea_145",2015,9,214,88,302
"5170","Zona_27-Area_74-Sottoarea_145",2015,10,225,119,344
"5171","Zona_27-Area_74-Sottoarea_145",2015,11,211,105,316
"5172","Zona_27-Area_74-Sottoarea_145",2015,12,197,94,291
"5173","Zona_27-Area_74-Sottoarea_145",2016,1,222,94,316
"5174","Zona_27-Area_74-Sottoarea_145",2016,2,246,110,356
"5175","Zona_27-Area_74-Sottoarea_145",2016,3,251,124,375
"5176","Zona_27-Area_74-Sottoarea_145",2016,4,227,100,327
"5177","Zona_27-Area_74-Sottoarea_145",2016,5,131,68,199
"5178","Zona_27-Area_74-Sottoarea_145",2016,6,0,0,0
"5179","Zona_27-Area_74-Sottoarea_145",2016,7,0,0,0
"5180","Zona_27-Area_74-Sottoarea_145",2016,8,0,0,0
"5181","Zona_27-Area_74-Sottoarea_145",2016,9,0,0,0
"5182","Zona_27-Area_74-Sottoarea_145",2016,10,0,0,0
"5183","Zona_27-Area_74-Sottoarea_145",2016,11,0,0,0
"5184","Zona_27-Area_74-Sottoarea_145",2016,12,0,0,0
